-1	マイナスイチ
-2	マイナスニ
-3	マイナスサン
-4	マイナスヨン
.jp	ドットジェイピー
.s	ドッツ
.zip	ジップ
100％	ヒャクパーセント
10世紀	ジッセイキ
10位	ジュウイ
10月	ジュウガツ
10月27日	ジュウガツニジュウシチニチ
10月28日	ジュウガツニジュウハチニチ
10月29日	ジュウガツニジュウキュウニチ
10月30日	ジュウガツサンジュウニチ
10月31日	ジュウガツサンジュウイチニチ
11位	ジュウイチイ
11月	ジュウイチガツ
11月1日	ジュウイチガツツイタチ
120種	ヒャクニジュウシュ
12位	ジュウニイ
13位	ジュウサンイ
14位	ジュウヨンイ
15位	ジュウゴイ
16位	ジュウロクイ
17位	ジュウナナイ
1916年	センキュウヒャクジュウロクネン
1948年	センキュウヒャクヨンジュウハチネ
1988年	センキュウヒャクハチジュウハチネン
1997年	センキュウヒャクキュウジュウナナ
1999年	センキュウヒャクキュウジュウキュウネン
1つ	ヒトツ
1人	ヒトリ
1位	イチイ
1月	イチガツ
1月1日	イチガツツイタチ
1月20日	イチガツハツカ
1月9日	イチガツココノカ
1本	イッポン
1枚	イチマイ
2002年	ニセンニネン
2004年	ニセンヨネン
2005年	ニセンゴネン
2009年	ニセンキュウネン
2010年	ニセンジュウネン
2011年	ニセンジュウイチネン
2016年	ニセンジュウロクネン
2018年	ニセンジュウハチネン
2022年	ニセンニジュウニネン
2024年	ニセンニジュウヨネン
2人	フタリ
2位	ニイ
2月	ニガツ
2月25日	ニガツニジュウゴニチ
2月5日	ニガツイツカ
2枚	ニマイ
30日	サンジュウニチ
3人	サンニン
3位	サンイ
3年	サンネン
3年間	サンネンカン
3日	ミッカ
3月	サンガツ
3月5日	サンガツイツカ
3本	サンボン
3枚	サンマイ
4位	ヨンイ
4月	シガツ
4月15日	シガツジュウゴニチ
4月20日	シガツハツカ
4月5日	シガツイツカ
5人	ゴニン
5位	ゴイ
5年	ゴネン
5月	ゴガツ
5月20日	ゴガツハツカ
6位	ロクイ
6月	ロクガツ
6月14日	ロクガツジュウヨッカ
6月15日	ロクガツジュウゴニチ
6月5日	ロクガツイツカ
700年	ナナヒャクネン
7位	ナナイ
7月	シチガツ
7月16日	シチガツジュウロクニチ
7月31日	シチガツサンジュウイチニチ
8位	ハチイ
8月	ハチガツ
8月11日	ハチガツジュウイチニチ
9世紀	キュウセイキ
9位	キュウイ
9月13日	クガツジュウサンニチ
9月17日	クガツジュウシチニチ
9月24日	クガツニジュウヨッカ
9月29日	クガツニジュウキュウニチ
Amazonプライム	アマゾンプライム
H.	エイチ
J-STAGE	ジェイステージ
JIS X 0213	ジスエックスゼロニイイチサン
ONE PIECE	ワンピース
René	ルネ
U.	ユー
http://	エイチティーティーピー
the c	ザシー
…。	サイレンス
あい	アイ
あいかわらず	アイカワラズ
あいず	アイズ
あいそ	アイソ
あいだ	アイダ
あいつ	アイツ
あいつら	アイツラ
あいづ	アイヅ
あいて	アイテ
あえか	アエカ
あおさ	アオサ
あか	アカ
あかし	アカシ
あからさま	アカラサマ
あかり	アカリ
あかんべえ	アカンベエ
あきらか	アキラカ
あき地	アキチ
あくび	アクビ
あくる日	アクルヒ
あぐら	アグラ
あぐり	アグリ
あけ	アケ
あけび	アケビ
あげく	アゲク
あこがれ	アコガレ
あご	アゴ
あさって	アサッテ
あさつき	アサツキ
あさはか	アサハカ
あざやか	アザヤカ
あし	アシ
あした	アシタ
あじ	アジ
あじゃ	アジャ
あす	アス
あすこ	アスコ
あずきバー	アズキバー
あそこ	アソコ
あたし	アタシ
あたり	アタリ
あたりまえ	アタリマエ
あだな	アダナ
あちこち	アチコチ
あちゃん	アチャン
あちら	アチラ
あっけ	アッケ
あっち	アッチ
あっぷる	アップル
あっ気	アッケ
あて	アテ
あと	アト
あとがき	アトガキ
あと足	アトアシ
あな	アナ
あなた	アナタ
あなた。	アナタ
あなたと	アナタト
あなたに	アナタニ
あなたのために	アナタノタメニ
あなたのように	アナタノヨウニ
あなたへ	アナタヘ
あにはからんや	アニハカランヤ
あのころ	アノコロ
あのまま	アノママ
あの世	アノヨ
あの国	アノクニ
あの男	アノオトコ
あはは	アハハ
あはれ	アハレ
あばた	アバタ
あぶら汗	アブラアセ
あべこべ	アベコベ
あぼかど	アボカド
あまた	アマタ
あまなつ	アマナツ
あまの川	アマノガワ
あまり	アマリ
あめりかん	アメリカン
あやまり	アヤマリ
あら	アラ
あらし	アラシ
あらすじ	アラスジ
あらら	アララ
あられ	アラレ
あら坊	アラボウ
ありか	アリカ
ありがた味	アリガタミ
ありがち	アリガチ
ありげ	アリゲ
ありさ	アリサ
ありま	アリマ
ありません	アリマセン
ありよう	アリヨウ
あるかな	アルカナ
あるまいと	アルマイト
ある意味	アルイミ
ある日	アルヒ
ある時	アルトキ
あれ	アレ
あれこれ	アレコレ
あれだけ	アレダケ
あん	アン
あんず	アンズ
あんた	アンタ
あんまり	アンマリ
あんみつ	アンミツ
あーもんど	アーモンド
あ行	アギョウ
い	イ
いいかえ	イイカエ
いいじゃありませんか	イイジャアリマセンカ
いいじゃない	イイジャナイ
いいね	イイネ
いいひと	イイヒト
いいもの	イイモノ
いい加減	イイカゲン
いい女	イイオンナ
いい訳	イイワケ
いおう	イオウ
いか	イカ
いかが	イカガ
いかさま師	イカサマシ
いかん	イカン
いきさつ	イキサツ
いきれ	イキレ
いく	イク
いくさ	イクサ
いくつ	イクツ
いくつか	イクツカ
いくつになっても	イクツニナッテモ
いくぶん	イクブン
いくら	イクラ
いざこざ	イザコザ
いしく	イシク
いじめ	イジメ
いす	イス
いずれ	イズレ
いそ	イソ
いその	イソノ
いぞく	イゾク
いたずら	イタズラ
いただき	イタダキ
いたち	イタチ
いたで	イタデ
いたん	イタン
いた事	イタコト
いちい	イチイ
いちいち	イチイチ
いちご	イチゴ
いちじく	イチジク
いちど	イチド
いちばん	イチバン
いちめん	イチメン
いっこ	イッコ
いっさい	イッサイ
いっしょ	イッショ
いって	イッテ
いっと	イット
いっぱい	イッパイ
いつ	イツ
いつか	イツカ
いつまでも	イツマデモ
いつまでもいつまでも	イツマデモイツマデモ
いつものように	イツモノヨウニ
いつ話	イツワ
いとこ	イトコ
いない	イナイ
いなせ	イナセ
いなりずし	イナリズシ
いなり寿司	イナリズシ
いの一番	イノイチバン
いびき	イビキ
いびつ	イビツ
いぼく	イボク
いま	イマ
いま川	イマガワ
いも	イモ
いや	イヤ
いやいや	イヤイヤ
いよかん	イヨカン
いらいら	イライラ
いらっしゃい	イラッシャイ
いらん	イラン
いりこ	イリコ
いりに	イリニ
いるか	イルカ
いるよ	イルヨ
いろいろ	イロイロ
いろは	イロハ
いろはにほへと	イロハニホヘト
いんげん	インゲン
い事	イジ
い人	イジン
い例	イレイ
い光	イコウ
い家	イカ
い掛	イカケ
い方	イホウ
い服	イフク
い本	イホン
い者	イシャ
い色	イショク
い草	イグサ
い質	イシツ
い都	イト
い間	イマ
ういろう	ウイロウ
うがい	ウガイ
うご	ウゴ
うごう	ウゴウ
うごき	ウゴキ
うしろ	ウシロ
うしろで	ウシロデ
うすで	ウスデ
うそ	ウソ
うそつき	ウソツキ
うた	ウタ
うたた寝	ウタタネ
うち	ウチ
うちに	ウチニ
うちの猫	ウチノネコ
うって	ウッテ
うつ	ウツ
うつつ	ウツツ
うど	ウド
うどん	ウドン
うな	ウナ
うな丼	ウナドン
うねり	ウネリ
うの	ウノ
うふ	ウフ
うま	ウマ
うまい	ウマイ
うまい棒	ウマイボウ
うむ	ウム
うめ	ウメ
うらなり	ウラナリ
うらら	ウララ
うり	ウリ
うれ	ウレ
うろ	ウロ
うわごと	ウワゴト
うわべ	ウワベ
うんそう	ウンソウ
う後	ウゴ
えさ	エサ
えぞ	エゾ
えだ	エダ
えだまめ	エダマメ
えつ	エツ
えて	エテ
えな	エナ
えのき	エノキ
えび	エビ
えり	エリ
えん	エン
えんど	エンド
えんぴつ	エンピツ
えんや	エンヤ
え段	エダン
おい	オイ
おいで	オイデ
おいでなさい	オイデナサイ
おいど	オイド
おいも	オイモ
おうと	オウト
おおざと	オオザト
おかき	オカキ
おかくれ	オカクレ
おかげ	オカゲ
おかず	オカズ
おかま	オカマ
おかゆ	オカユ
おかん	オカン
おがら	オガラ
おきゃん	オキャン
おぎゃあ	オギャア
おくび	オクビ
おくら	オクラ
おく方	オクガタ
おけら	オケラ
おさと	オサト
おさん	オサン
おし	オシ
おしっこ	オシッコ
おしまい	オシマイ
おしゃべり	オシャベリ
おしゃれ	オシャレ
おしるこ	オシルコ
おじいさん	オジイサン
おじぎ	オジギ
おじさん	オジサン
おたずね	オタズネ
おだやか	オダヤカ
おちゃ	オチャ
おっかさん	オッカサン
おっくう	オックウ
おっぱい	オッパイ
おでき	オデキ
おでん	オデン
おとな	オトナ
おどけ	オドケ
おなか	オナカ
おなら	オナラ
おなり	オナリ
おにぎり	オニギリ
おにぎりせんべい	オニギリセンベイ
おねがい	オネガイ
おの	オノ
おのれ	オノレ
おは	オハ
おはぎ	オハギ
おばあさん	オバアサン
おひたし	オヒタシ
おひつ	オヒツ
おふくろ	オフクロ
おべっか	オベッカ
おぼえ	オボエ
おぼろげ	オボロゲ
おまえ	オマエ
おまえに	オマエニ
おまかせ	オマカセ
おまけ	オマケ
おみやげ	オミヤゲ
おもしろ	オモシロ
おもち	オモチ
おもちゃ	オモチャ
おもちゃ屋	オモチャヤ
おもに	オモニ
おもり	オモリ
おやじ	オヤジ
おや御	オヤゴ
および	オヨビ
おら	オラ
おり	オリ
おりーぶ	オリーブ
おれ	オレ
おれは空	オレハソラ
おれんじ	オレンジ
おんな	オンナ
お上	オカミ
お世話	オセワ
お世辞	オセジ
お互	オタガイ
お互い	オタガイ
お仕事	オシゴト
お伴	オトモ
お便	オタヨリ
お出で	オイデ
お前	オマエ
お勝手	オカッテ
お化け	オバケ
お参り	オマイリ
お古	オフル
お召	オメシ
お告げ	オツゲ
お国	オクニ
お土産	オミヤゲ
お好み焼き	オコノミヤキ
お婆さん	オバアサン
お嬢さん	オジョウサン
お宅	オタク
お客	オキャク
お客さま	オキャクサマ
お客様	オキャクサマ
お宮	オミヤ
お家	オイエ
お寺	オテラ
お小遣い	オコヅカイ
お巡り	オマワリ
お座敷	オザシキ
お待ち	オマチ
お待遠さま	オマチドオサマ
お慰	オナグサミ
お手伝い	オテツダイ
お手本	オテホン
お敷	オシキ
お昼	オヒル
お構い	オカマイ
お正月	オショウガツ
お母さん	オカアサン
お気	オキ
お気の毒さま	オキノドクサマ
お気の毒様	オキノドクサマ
お湯	オユ
お澄し	オスマシ
お父さん	オトウサン
お父ちゃん	オトウチャン
お爺さん	オジイサン
お盆	オボン
お相手	オアイテ
お礼	オレイ
お祈り	オイノリ
お祝い	オイワイ
お祭	オマツリ
お祭り	オマツリ
お腰	オコシ
お腹	オナカ
お芝居	オシバイ
お茶	オチャ
お茶漬け	オチャヅケ
お茶目	オチャメ
お菓子	オカシ
お蔭	オカゲ
お蔭様	オカゲサマ
お袋	オフクロ
お許し	オユルシ
お話	オハナシ
お話し	オハナシ
お談義	オダンギ
お豆腐	オトウフ
お貰	オモライ
お貰い	オモライ
お転婆	オテンバ
お辞儀	オジギ
お酌	オシャク
お酒	オサケ
お金	オカネ
お金持ち	オカネモチ
お釣	オツリ
お門ちがい	オカドチガイ
お陰	オカゲ
お雑煮	オゾウニ
お願い	オネガイ
お餅	オモチ
かい	カイ
かいわれ	カイワレ
かう	カウ
かえて	カエテ
かおり	カオリ
かおる	カオル
かおる子	カオルコ
かかり	カカリ
かかりつけ	カカリツケ
かがやき	カガヤキ
かき	カキ
かき餅	カキモチ
かぎ	カギ
かぎり	カギリ
かく	カク
かくした	カクシタ
かくし子	カクシゴ
かくよう	カクヨウ
かぐや姫	カグヤヒメ
かけ	カケ
かけそば	カケソバ
かげ	カゲ
かげま	カゲマ
かご	カゴ
かさ	カサ
かさかさ	カサカサ
かさん	カサン
かし	カシ
かしく	カシク
かしこ	カシコ
かしら	カシラ
かじ	カジ
かす	カス
かすか	カスカ
かすたーど	カスタード
かすと	カスト
かた	カタ
かたがた	カタガタ
かたち	カタチ
かちかち山	カチカチヤマ
かったん	カッタン
かって口	カッテグチ
かっと	カット
かっぱえびせん	カッパエビセン
かっぽれ	カッポレ
かつおだし	カツオダシ
かつごう	カツゴウ
かとん	カトン
かど	カド
かど地	カドチ
かな	カナ
かなしみ	カナシミ
かなめ	カナメ
かなり	カナリ
かなる	カナル
かに	カニ
かね	カネ
かぼす	カボス
かぼちゃ	カボチャ
かまた	カマタ
かみさん	カミサン
かむ	カム
かめ	カメ
かよく	カヨク
からあげ	カラアゲ
からい	カライ
からかい	カラカイ
からから	カラカラ
からくり	カラクリ
からだ	カラダ
からっぽ	カラッポ
かりそめ	カリソメ
かりんとう	カリントウ
かり取	カリトリ
かわら	カワラ
かわり	カワリ
かん	カン
かんきつ類	カンキツルイ
かんしょ	カンショ
かんじん	カンジン
かんと	カント
か事	カジ
か称	カショウ
か行	カギョウ
か賞	カショウ
か金	カキン
がい	ガイ
がいや	ガイヤ
がかり	ガカリ
がき	ガキ
がけ	ガケ
がご	ガゴ
がさ	ガサ
がそ	ガソ
がた	ガタ
がたぴし	ガタピシ
がち	ガチ
がま	ガマ
がま口	ガマグチ
がみ	ガミ
がや	ガヤ
がら	ガラ
がらがら	ガラガラ
がらん	ガラン
がりがり	ガリガリ
がん	ガン
きいた	キイタ
きうい	キウイ
きが	キガ
きき	キキ
きく	キク
きくの	キクノ
きくよ	キクヨ
きさく	キサク
きさつ	キサツ
きしゃご	キシャゴ
きた	キタ
きっこ	キッコ
きっと	キット
きなこ棒	キナコボウ
きの	キノ
きのう	キノウ
きのこの山	キノコノヤマ
きは	キハ
きまり	キマリ
きみ	キミ
きみの	キミノ
きもの	キモノ
きゃしゃ	キャシャ
きゅうくつ	キュウクツ
きゅうり	キュウリ
きょう	キョウ
きょうは	キョウハ
きょほ	キョホ
きょろきょろ	キョロキョロ
きらい	キライ
きらびやか	キラビヤカ
きらん	キラン
きり	キリ
きりきり舞い	キリキリマイ
きりん	キリン
きると	キルト
きれい	キレイ
きれいな	キレイナ
きれぎれ	キレギレ
きんかん	キンカン
きんぴらごぼう	キンピラゴボウ
き付け	キツケ
き意	キイ
き抜	キヌケ
き立	キダテ
き者	キシャ
ぎく	ギク
ぎごち	ギゴチ
ぎざぎざ	ギザギザ
ぎそう	ギソウ
ぎだ	ギダ
ぎんが	ギンガ
ぎ足	ギソク
くいん	クイン
くさび	クサビ
くし	クシ
くせ	クセ
くたくた	クタクタ
くだもの	クダモノ
くちばし	クチバシ
くちゃくちゃ	クチャクチャ
くなん	クナン
くに	クニ
くも	クモ
くら	クラ
くらし	クラシ
くらんべりー	クランベリー
くり	クリ
くるみ	クルミ
くん	クン
く味	クミ
く海	クカイ
く間	クカン
ぐしょぐしょ	グショグショ
ぐたぐた	グタグタ
ぐみ	グミ
ぐり	グリ
ぐる	グル
ぐるみ	グルミ
ぐれーぷふるーつ	グレープフルーツ
けい	ケイ
けいけん	ケイケン
けいさつ	ケイサツ
けいさつかん	ケイサツカン
けいざい	ケイザイ
けいじばん	ケイジバン
けいと	ケイト
けいば	ケイバ
けいび	ケイビ
けいま	ケイマ
けいむしょ	ケイムショ
けいやく	ケイヤク
けいれき	ケイレキ
けが	ケガ
けさ	ケサ
けさの	ケサノ
けし	ケシ
けしき	ケシキ
けた	ケタ
けち	ケチ
けちん坊	ケチンボウ
けっか	ケッカ
けっこん	ケッコン
けっさく	ケッサク
けっしん	ケッシン
けっせい	ケッセイ
けつえき	ケツエキ
けつろん	ケツロン
けもの	ケモノ
けやき	ケヤキ
けらい	ケライ
けり	ケリ
けんお	ケンオ
けんか	ケンカ
けんきゅう	ケンキュウ
けんこう	ケンコウ
けんさ	ケンサ
けんじょ	ケンジョ
けんちん汁	ケンチンジル
けんぽう	ケンポウ
けんめい	ケンメイ
けんり	ケンリ
げ	ゲ
げすと	ゲスト
げた	ゲタ
げる	ゲル
げろ	ゲロ
げーと	ゲート
こ	コ
こいつ	コイツ
こうか	コウカ
こうこ	コウコ
こうめ	コウメ
こう明	コウメイ
こおどり	コオドリ
ここ	ココ
ここいら	ココイラ
ここなっつ	ココナッツ
ここに	ココニ
ここまでおいで	ココマデオイデ
ここら	ココラ
こころ	ココロ
こごと	コゴト
こごみ	コゴミ
こしらえ	コシラエ
こすと	コスト
こせこせ	コセコセ
こたつ	コタツ
こだわり	コダワリ
こち	コチ
こちら	コチラ
こっち	コッチ
こっち側	コッチガワ
こと	コト
ことこと	コトコト
ことし	コトシ
ことば	コトバ
ことり	コトリ
こども	コドモ
こないだ	コナイダ
このか	コノカ
このごろ	コノゴロ
このへん	コノヘン
このほど	コノホド
このまま	コノママ
この三人	コノサンニン
この世	コノヨ
この国	コノクニ
この声	コノコエ
この女	コノオンナ
この方	コノホウ
この辺	コノヘン
この道	コノミチ
この間	コノカン
こは	コハ
こぶ	コブ
こぶし	コブシ
こぼん	コボン
こまか	コマカ
こまつ	コマツ
こま結び	コマムスビ
こみち	コミチ
これ	コレ
これしき	コレシキ
これだけ	コレダケ
これはひどい	コレハヒドイ
これら	コレラ
ころ	コロ
ころり	コロリ
ころん	コロン
こん	コン
こんど	コンド
こんな	コンナ
こん度	コンド
ごちそう	ゴチソウ
ごつごつ	ゴツゴツ
ごと	ゴト
ごとし	ゴトシ
ごはん	ゴハン
ごぼう	ゴボウ
ごまかし	ゴマカシ
ごまだれ	ゴマダレ
ごまだんご	ゴマダンゴ
ごまドレッシング	ゴマドレッシング
ごま油	ゴマアブラ
ごみ	ゴミ
ごめん	ゴメン
ごめんね	ゴメンネ
ごめんね。	ゴメンネ
ごもっとも	ゴモットモ
ごらん	ゴラン
ごろ	ゴロ
ごろごろ	ゴロゴロ
ごろつき	ゴロツキ
ご免	ゴメン
ご存じ	ゴゾンジ
ご存知	ゴゾンジ
ご機嫌	ゴキゲン
ご気	ゴキ
ご沙汰	ゴサタ
ご無沙汰	ゴブサタ
ご用	ゴヨウ
ご膳	ゴゼン
ご苦労	ゴクロウ
ご覧	ゴラン
ご酒	ゴシュ
ご飯	ゴハン
ご馳走	ゴチソウ
さ	サ
さい	サイ
さいは	サイハ
さいわい	サイワイ
さい子	サイシ
さえ子	サエコ
さかさ	サカサ
さかな	サカナ
さかん	サカン
さき	サキ
さくらんぼ	サクランボ
さけ	サケ
さげん	サゲン
ささやか	ササヤカ
さして	サシテ
さしみ	サシミ
さし身	サシミ
さそり	サソリ
さっき	サッキ
さつまいも	サツマイモ
さと	サト
さといも	サトイモ
さとう	サトウ
さと音	サトネ
さな	サナ
さなだ虫	サナダムシ
さぬき	サヌキ
さば	サバ
さま	サマ
さまざま	サマザマ
さや	サヤ
さやいんげん	サヤインゲン
さやえんどう	サヤエンドウ
さようし	サヨウシ
さよの	サヨノ
さらい	サライ
さらん	サラン
さる	サル
さわやか	サワヤカ
さん	サン
さんずい	サンズイ
さんま	サンマ
さんまで	サンマデ
さんよ	サンヨ
さ行	サギョウ
ざくろ	ザクロ
ざくろ口	ザクログチ
ざま	ザマ
ざらめ	ザラメ
ざる	ザル
ざるそば	ザルソバ
ざわざわ	ザワザワ
ざんしょう	ザンショウ
しあ	シア
しあわせ	シアワセ
しおり	シオリ
しか	シカ
しかた	シカタ
しき	シキ
しきもの	シキモノ
しぐ	シグ
しげみ	シゲミ
しこう	シコウ
しごき	シゴキ
ししとう	シシトウ
ししゃも	シシャモ
しず	シズ
しずか	シズカ
しそ	シソ
しそう	シソウ
した	シタ
したて	シタテ
したり顔	シタリガオ
した書	シタガキ
した腹	シタハラ
しだ	シダ
しった	シッタ
しっぽ	シッポ
しどころ	シドコロ
しどろ	シドロ
しどろもどろ	シドロモドロ
しな	シナ
しない	シナイ
しながら	シナガラ
しの	シノ
しびれ	シビレ
しま	シマ
しまいま	シマイマ
しません	シマセン
しまり	シマリ
しみ	シミ
しめじ	シメジ
しめ出し	シメダシ
しゃいん	シャイン
しゃくい	シャクイ
しゃけ	シャケ
しゃつ	シャツ
しゃぶしゃぶ	シャブシャブ
しゃべる	シャベル
しゃもじ	シャモジ
しゃれ	シャレ
しや	シヤ
しゅん	シュン
しょ	ショ
しょう	ショウ
しょうが	ショウガ
しょくよう	ショクヨウ
しょっと	ショット
しよう	シヨウ
しら	シラ
しらす	シラス
しるし	シルシ
しろうさぎ	シロウサギ
しん	シン
しんみり	シンミリ
しーく	シーク
しーめ	シーメ
し事	シジ
し向	シコウ
じい	ジイ
じいさん	ジイサン
じいろ	ジイロ
じき	ジキ
じさ	ジサ
じじい	ジジイ
じた	ジタ
じっさい	ジッサイ
じゃあね	ジャアネ
じゃあの	ジャアノ
じゃがいも	ジャガイモ
じゃがりこ	ジャガリコ
じゃっく	ジャック
じゃどう	ジャドウ
じゃま	ジャマ
じゃよく	ジャヨク
じゅう	ジュウ
じろ	ジロ
じ候	ジコウ
じ前	ジマエ
じ機	ジキ
す	ス
すいか	スイカ
すいーと	スイート
すか	スカ
すかし	スカシ
すき	スキ
すきや	スキヤ
すき焼き	スキヤキ
すき焼きのたれ	スキヤキノタレ
すぎ	スギ
すぎ原	スギハラ
すぐり	スグリ
すこし	スコシ
すし	スシ
すすき	ススキ
すすきの	ススキノ
すそ	スソ
すたー	スター
すだち	スダチ
すてき	ステキ
すで	スデ
すと	スト
すなお	スナオ
すね	スネ
すべ	スベ
すべて	スベテ
すべり	スベリ
すまし汁	スマシジル
すまた	スマタ
すもも	スモモ
すり	スリ
すれすれ	スレスレ
すんで	スンデ
ずく	ズク
ずくめ	ズクメ
ずし	ズシ
ずたずた	ズタズタ
ずっとずっと	ズットズット
ずぼら	ズボラ
ずぼん	ズボン
ずみ	ズミ
ずり	ズリ
ずる	ズル
ずれ	ズレ
ず無	ズナシ
せい	セイ
せいせい	セイセイ
せがれ	セガレ
せきはん	セキハンオオモリシンヤ
せこんど	セコンド
せし	セシ
せっかくだから	セッカクダカラ
せっかち	セッカチ
せな	セナ
せり	セリ
せりふ	セリフ
せわ	セワ
せん	セン
せんだって	センダッテ
せんばい	センバイ
せんべい	センベイ
ぜいたく	ゼイタク
ぜひ	ゼヒ
ぜん	ゼン
ぜんたい	ゼンタイ
ぜんまい	ゼンマイ
そ	ソ
そいつ	ソイツ
そう	ソウ
そうかな	ソウカナ
そうかもしれない	ソウカモシレナイ
そうこう	ソウコウ
そうじゃない	ソウジャナイ
そうそう	ソウソウ
そうだ	ソウダ
そうに	ソウニ
そうめん	ソウメン
そう勢	ソウゼイ
そう急	ソウキュウ
そう木	ソウモク
そう極	ソウキョク
そげん	ソゲン
そこ	ソコ
そこい	ソコイ
そこら	ソコラ
そそく	ソソク
そぞろ心	ソゾロゴコロ
そちら	ソチラ
そっち	ソッチ
そっちのけ	ソッチノケ
そっぷ	ソップ
そと	ソト
そのため	ソノタメ
そのほか	ソノホカ
そのままで	ソノママデ
そのもの	ソノモノ
そのよう	ソノヨウ
その他	ソノタ
その子	ソノコ
その後	ソノゴ
その昔	ソノムカシ
その歌	ソノカ
その物	ソノモノ
その道	ソノミチ
その間	ソノカン
その頃	ソノコロ
そば	ソバ
そもそも	ソモソモ
そらの	ソラノ
そらまめ	ソラマメ
そら豆	ソラマメ
そら音	ソラネ
そり	ソリ
そりゃ	ソリャ
そりゃあ	ソリャア
それ	ソレ
それが大事	ソレガダイジ
それぞれ	ソレゾレ
それどころ	ソレドコロ
それなり	ソレナリ
それにしてもこの	ソレニシテモコノ
それや	ソレヤ
それら	ソレラ
そん	ソン
ぞくぞく	ゾクゾク
たい	タイ
たいがい	タイガイ
たいこ	タイコ
たいと	タイト
たい人	タイジン
たい焼き	タイヤキ
たい話	タイワ
たき	タキ
たくさん	タクサン
たくない	タクナイ
たけ	タケ
たけのこ	タケノコ
たけのこの里	タケノコノサト
たこ	タコ
たこめし	タコメシ
たこ焼き	タコヤキ
たしか	タシカ
たそう	タソウ
たたり	タタリ
ただ	タダ
ただお	タダオ
ただ今	タダイマ
たち	タチ
たちまち	タチマチ
たつの	タツノ
たて	タテ
たどう	タドウ
たに行	タニイキ
たのみ	タノミ
たのもし	タノモシ
たは	タハ
たひ	タヒ
たび	タビ
たま	タマ
たまえ	タマエ
たまごかけごはん	タマゴカケゴハン
たまごやき	タマゴヤキ
たまねぎ	タマネギ
ため	タメ
ためいき	タメイキ
ためし	タメシ
たよ	タヨ
たより	タヨリ
たらのめ	タラノメ
たる	タル
たれ	タレ
たわい	タワイ
たん	タン
たんこぶ	タンコブ
たんだい	タンダイ
たんび	タンビ
た事	タジ
た人	タニン
た作	タヅクリ
た元	タゲン
た出	タシュツ
た大	タダイ
た家	タケ
た意	タイ
た方	タホウ
た様	タヨウ
た毛	タモウ
た物	タブツ
た用	タヨウ
た罪	タザイ
た者	タシャ
た行	タコウ
た趣味	タシュミ
た遊び	タアソビ
た雨	タウ
だい	ダイ
だいこん	ダイコン
だいず	ダイズ
だいち	ダイチ
だい紙	ダイシ
だかん	ダカン
だき	ダキ
だし	ダシ
だだっ子	ダダッコ
だて	ダテ
だは	ダハ
だぶだぶ	ダブダブ
だめ	ダメ
だもの	ダモノ
だらけ	ダラケ
だらし	ダラシ
だる	ダル
だれ	ダレ
だれか	ダレカ
だれかれ	ダレカレ
だんだら	ダンダラ
だんまり	ダンマリ
ちぇりー	チェリー
ちがい	チガイ
ちきりん	チキリン
ちくま文庫	チクマブンコ
ちくま日本文学全集	チクマニホンブンガクゼンシュウ
ちの	チノ
ちまた	チマタ
ちゃらちゃら	チャラチャラ
ちゃん	チャン
ちゃんこ鍋	チャンコナベ
ちゃんぽん	チャンポン
ちゃ事	チャジ
ちゅ	チュ
ちゅうと	チュウト
ちょ	チョ
ちょく	チョク
ちょん	チョン
ちょん切る	チョンギル
ちょん髷	チョンマゲ
ちらしずし	チラシズシ
ちらし寿司	チラシズシ
ちり	チリ
ちんげんさい	チンゲンサイ
ぢ	ヂ
っきり	ッキリ
っ子	ッコ
ついで	ツイデ
つうご	ツウゴ
つがる	ツガル
つき	ツキ
つきの	ツキノ
つきもの	ツキモノ
つき出し	ツキダシ
つき合	ツキアイ
つき番	ツキバン
つぎ	ツギ
つくつく法師	ツクツクボウシ
つけ	ツケ
つけたり	ツケタリ
つけめん	ツケメン
つけ焼	ツケヤキ
つっかけ	ツッカケ
つづら	ツヅラ
つて	ツテ
つながり	ツナガリ
つな引	ツナヒキ
つぶ	ツブ
つま	ツマ
つまみ	ツマミ
つまり	ツマリ
つむじ	ツムジ
つもり	ツモリ
つらさ	ツラサ
つらら	ツララ
つらら女	ツララオンナ
つりがねそう	ツリガネソウ
つる	ツル
つるの	ツルノ
つるはし	ツルハシ
つれづれ	ツレヅレ
つんつるてん	ツンツルテン
つ折	ツオリ
づくし	ヅクシ
てい	テイ
ていかん	テイカン
ていさい	テイサイ
ていたらく	テイタラク
ていねい	テイネイ
ていは	テイハ
ておし	テオシ
てこ	テコ
てっこ	テッコ
てのひら	テノヒラ
てはい	テハイ
てへん	テヘン
てりや	テリヤ
てんてつ	テンテツ
てんにょ	テンニョ
てんぷら	テンプラ
て出	テダシ
て書	テガキ
て書き	テガキ
でおくれ	デオクレ
ですか	デスカ
でせん	デセン
でどこ	デドコ
では	デハ
ではいり	デハイリ
でま	デマ
でもの	デモノ
とい	トイ
とうがらし	トウガラシ
とうしろ	トウシロ
とうと	トウト
とうもろこし	トウモロコシ
とおり	トオリ
とき	トキ
ときどき	トキドキ
とく	トク
とくは	トクハ
とく例	トクレイ
とぐろ	トグロ
とこ	トコ
ところ	トコロ
ところてん	トコロテン
とせん	トセン
とそ	トソ
とたん	トタン
とちめんぼう	トチメンボウ
とっく	トック
とっさ	トッサ
とど	トド
となり	トナリ
との	トノ
とはいえ	トハイエ
とも	トモ
とら	トラ
とり	トリ
とりで	トリデ
とれい	トレイ
とろう	トロウ
とろろ汁	トロロジル
とんかつ	トンカツ
とんかつソース	トンカツソース
とんこつラーメン	トンコツラーメン
とんでも	トンデモ
とん子	トンコ
どうし	ドウシ
どうしたらいいの	ドウシタライイノ
どうでしょう	ドウデショウ
どうにかなるさ	ドウニカナルサ
どうもこうも	ドウモコウモ
どうり	ドウリ
どおり	ドオリ
どきどき	ドキドキ
どぎまぎ	ドギマギ
どこ	ドコ
どこか	ドコカ
どころ	ドコロ
どちら	ドチラ
どっか	ドッカ
どっち	ドッチ
どなた	ドナタ
どの人	ドノヒト
どぶ鼠	ドブネズミ
ども	ドモ
どら	ドラ
どらごん	ドラゴン
どらやき	ドラヤキ
どら焼き	ドラヤキ
どりあん	ドリアン
どれ	ドレ
どろどろ	ドロドロ
どん	ドン
どんと	ドント
どんどこ	ドンドコ
どんぶり	ドンブリ
なあに	ナアニ
ないか	ナイカ
ないと	ナイト
ないや	ナイヤ
ないん	ナイン
ない分	ナイブン
ない所	ナイトコロ
ない食	ナイショク
なうて	ナウテ
なおと	ナオト
なおのこと	ナオノコト
なか	ナカ
なぎさ	ナギサ
なぐさみ	ナグサミ
なげ	ナゲ
なし	ナシ
なし崩し	ナシクズシ
なじ	ナジ
なじみ	ナジミ
なす	ナス
なずな	ナズナ
なぜだか	ナゼダカ
なっちまう	ナッチマウ
なっつ	ナッツ
なつみかん	ナツミカン
なつめ	ナツメ
なに	ナニ
なにがし	ナニガシ
なのか	ナノカ
なのだ	ナノダ
なば	ナバ
なべ	ナベ
なめくじ	ナメクジ
なめこ	ナメコ
なり	ナリ
なりて	ナリテ
なり手	ナリテ
なろう	ナロウ
なん	ナン
なんこ	ナンコ
なんだい	ナンダイ
なんだろう	ナンダロウ
なんと	ナント
なんど	ナンド
なんなんと	ナンナント
なんの	ナンノ
なんべん	ナンベン
なんぼ	ナンボ
な行	ナギョウ
な音	ナオト
にあ	ニア
にいな	ニイナ
におい	ニオイ
にぎやか	ニギヤカ
にくじゃが	ニクジャガ
にこにこ	ニコニコ
にし	ニシ
にせもの	ニセモノ
につぎ	ニツギ
にな	ニナ
にほんとう	ニホントウ
にぼ	ニボ
にも	ニモ
にゅうめん	ニュウメン
にら	ニラ
にわし	ニワシ
にわとこ	ニワトコ
にんじん	ニンジン
にんにく	ニンニク
にんにくの芽	ニンニクノメ
に物	ニモノ
ぬい	ヌイ
ぬいぐるみ	ヌイグルミ
ぬかどこ	ヌカドコ
ぬかみそ	ヌカミソ
ぬすみ	ヌスミ
ぬた	ヌタ
ぬめり	ヌメリ
ぬりえ	ヌリエ
ぬれぎぬ	ヌレギヌ
ぬれ煎餅	ヌレセンベイ
ねえさん	ネエサン
ねえや	ネエヤ
ねぎ	ネギ
ねぎとろ	ネギトロ
ねじ	ネジ
ねだん	ネダン
ねばねば	ネバネバ
ねばり	ネバリ
ね上げ	ネアゲ
ね起	ネオキ
の	ノ
のうさぎ	ノウサギ
のがれ	ノガレ
のし	ノシ
のたれ死に	ノタレジニ
のち	ノチ
のっぺらぼう	ノッペラボウ
のっぺり	ノッペリ
のところ	ノトコロ
のど	ノド
のり	ノリ
のろけ	ノロケ
のろし	ノロシ
のんき	ノンキ
はいい	ハイイ
はいはい	ハイハイ
はいらん	ハイラン
はいる	ハイル
はいろう	ハイロウ
はえ	ハエ
はおれ	ハオレ
はか	ハカ
はかく	ハカク
はがき	ハガキ
はきだめ	ハキダメ
はくさい	ハクサイ
はこん	ハコン
はごく	ハゴク
はさ	ハサ
はさみ	ハサミ
はしがき	ハシガキ
はした	ハシタ
はしません	ハシマセン
はじ	ハジ
はじまり	ハジマリ
はじまり、	ハジマリ
はじめ	ハジメ
はず	ハズ
はずみ	ハズミ
はずれ	ハズレ
はた	ハタ
はたき	ハタキ
はたち	ハタチ
はだし	ハダシ
はち	ハチ
はちみつ	ハチミツ
はっく	ハック
はっさく	ハッサク
はて	ハテ
はと	ハト
はなして	ハナシテ
はなやか	ハナヤカ
はふ	ハフ
はへん	ハヘン
はぼう	ハボウ
はま	ハマ
はまこ	ハマコ
はまなし	ハマナシ
はもと	ハモト
はやて	ハヤテ
はるか	ハルカ
はん	ハン
は元	ハモト
は折れ	ハオレ
は落	ハオチ
は落ち	ハオチ
は行	ハギョウ
ば	バ
ばい	バイ
ばいかん	バイカン
ばう	バウ
ばか	バカ
ばけ	バケ
ばってん	バッテン
ばっと	バット
ばつ	バツ
ばなな	バナナ
ばね	バネ
ばら	バラ
ばらばら	バラバラ
ばれいしょ	バレイショ
ばん	バン
ぱいなっぷる	パイナップル
ぱっしょん	パッション
ぱぱいや	パパイヤ
ぱん	パン
ひいき	ヒイキ
ひじき煮	ヒジキニ
ひそか	ヒソカ
ひたかくし	ヒタカクシ
ひた隠し	ヒタカクシ
ひだ	ヒダ
ひと	ヒト
ひとたち	ヒトタチ
ひとつ	ヒトツ
ひとは	ヒトハ
ひとり	ヒトリ
ひとりご	ヒトリゴ
ひとり口	ヒトリグチ
ひと通り	ヒトトオリ
ひどく	ヒドク
ひな	ヒナ
ひなたぼっこ	ヒナタボッコ
ひのき	ヒノキ
ひび	ヒビ
ひび割れ	ヒビワレ
ひま	ヒマ
ひまつぶし	ヒマツブシ
ひま人	ヒマジン
ひま潰し	ヒマツブシ
ひも	ヒモ
ひやひや	ヒヤヒヤ
ひょっと	ヒョット
ひろく	ヒロク
びし	ビシ
びたし	ビタシ
びっくり	ビックリ
びら	ビラ
びる	ビル
びろうど	ビロウド
びわ	ビワ
びん	ビン
び動	ビドウ
ぴき	ピキ
ぴんと	ピント
ふぃんがー	フィンガー
ふう	フウ
ふえて	フエテ
ふか	フカ
ふき	フキ
ふきのとう	フキノトウ
ふくろう	フクロウ
ふし	フシ
ふしぎ	フシギ
ふじ	フジ
ふじの山	フジノヤマ
ふた	フタ
ふたり	フタリ
ふた言目	フタコトメ
ふだん	フダン
ふだん着	フダンギ
ふち	フチ
ふつ	フツ
ふところ	フトコロ
ふびん	フビン
ふふ	フフ
ふみ	フミ
ふり	フリ
ふり出し	フリダシ
ふるーつ	フルーツ
ふん	フン
ふんどし	フンドシ
ぶしつけ	ブシツケ
ぶどう	ブドウ
ぶら	ブラ
ぶらっく	ブラック
ぶらんこ	ブランコ
ぶり	ブリ
ぶるーべりー	ブルーベリー
ぶん	ブン
ぶんぶん	ブンブン
ぶ人	ブジン
ぷっちょ	プッチョ
へ	ヘ
へとへと	ヘトヘト
へべれけ	ヘベレケ
へり	ヘリ
へん	ヘン
へん年	ヘンネン
べた	ベタ
べた一面	ベタイチメン
べっかんこう	ベッカンコウ
べったく	ベッタク
べつ	ベツ
べて	ベテ
べら	ベラ
べらぼう	ベラボウ
べらんめえ	ベランメエ
べりー	ベリー
べる	ベル
べるの	ベルノ
ぺてん	ペテン
ぺん	ペン
ほう	ホウ
ほうがんびいき	ホウガンビイキ
ほうほう	ホウホウ
ほうれんそう	ホウレンソウ
ほうれん草	ホウレンソウ
ほおずき	ホオズキ
ほか	ホカ
ほがらか	ホガラカ
ほこり	ホコリ
ほしいもの	ホシイモノ
ほたて	ホタテ
ほととぎす	ホトトギス
ほとり	ホトリ
ほど	ホド
ほの	ホノ
ほのか	ホノカ
ほわいと	ホワイト
ほん	ホン
ほんだし	ホンダシ
ほんと	ホント
ほんとう	ホントウ
ほんとうに	ホントウニ
ほん当	ホントウ
ぼうと	ボウト
ぼく	ボク
ぼくが	ボクガ
ぼくら	ボクラ
ぼく知	ボクチ
ぼし	ボシ
ぼや	ボヤ
ぼろ	ボロ
ぼろぼろ	ボロボロ
ぼんやり	ボンヤリ
ぼーと	ボート
ぽか	ポカ
ぽじ	ポジ
ぽつ	ポツ
ぽろぽろ	ポロポロ
ぽんかん	ポンカン
ぽんぽん	ポンポン
まあ	マア
まいか	マイカ
まえび	マエビ
まかせなさい	マカセナサイ
まき	マキ
まぐろ	マグロ
まごまご	マゴマゴ
まさ	マサ
まし	マシ
まじない	マジナイ
まじめ	マジメ
ます	マス
ますから	マスカラ
ますくめろん	マスクメロン
まずさ	マズサ
またたく間	マタタクマ
また上	マタウエ
また旅	マタタビ
まだら	マダラ
まち	マチ
まった	マッタ
まったん	マッタン
まってい	マッテイ
まっ白	マッシロ
まっ青	マッサオ
まっ黒	マックロ
まつ	マツ
まつたけ	マツタケ
まとも	マトモ
まなこ	マナコ
まに	マニ
まぶ	マブ
まほう	マホウ
まま	ママ
まめ	マメ
まめもやし	マメモヤシ
まら	マラ
まり	マリ
まりも	マリモ
まるめろ	マルメロ
まれ	マレ
まわり	マワリ
まんごすちん	マンゴスチン
まんごー	マンゴー
まんじゅう	マンジュウ
まん中	マンナカ
ま向い	マムカイ
ま行	マギョウ
み	ミ
みかん	ミカン
みじめ	ミジメ
みじん	ミジン
みずから	ミズカラ
みずな	ミズナ
みそ	ミソ
みたい	ミタイ
みたらし	ミタラシ
みたらし団子	ミタラシダンゴ
みだり	ミダリ
みち	ミチ
みっこ	ミッコ
みつ	ミツ
みつば	ミツバ
みな	ミナ
みなさん	ミナサン
みなも	ミナモ
みに	ミニ
みみず	ミミズ
みやげ	ミヤゲ
みょうが	ミョウガ
みりん	ミリン
みりん風調味料	ミリンフウチョウミリョウ
みると	ミルト
みんな	ミンナ
みんなマドンナ	ミンナマドンナ
み合い	ミアイ
み込	ミコミ
むかし	ムカシ
むかっ腹	ムカッパラ
むき	ムキ
むき出し	ムキダシ
むしろ	ムシロ
むすこ	ムスコ
むだ	ムダ
むべ	ムベ
むま	ムマ
むやみ	ムヤミ
むら	ムラ
め	メ
めい	メイ
めいた	メイタ
めいめい	メイメイ
めし	メシ
めず	メズ
めた	メタ
めたる	メタル
めたん	メタン
めだし	メダシ
めちゃめちゃ	メチャメチャ
めった	メッタ
めて	メテ
めど	メド
めの	メノ
めまい	メマイ
めりんす	メリンス
めろ	メロ
めろん	メロン
めん	メン
めんつゆ	メンツユ
めん子	メンコ
め見	メミエ
め顔	メガオ
もうあ	モウア
もうい	モウイ
もういちど	モウイチド
もうおしまい	モウオシマイ
もうけ	モウケ
もうこ	モウコ
もうだん	モウダン
もう一歩	モウイッポ
もう一歩前へ	モウイッポマエヘ
もう半分	モウハンブン
もう火	モウカ
もか	モカ
もし	モシ
もち	モチ
もったい	モッタイ
もってのほか	モッテノホカ
もっての外	モッテノホカ
もっとも	モットモ
もっともっと	モットモット
もっと強く	モットツヨク
もつ鍋	モツナベ
もと	モト
もなか	モナカ
もの	モノ
ものさし	モノサシ
ものしずか	モノシズカ
もの事	モノゴト
もの思い	モノオモイ
もの静か	モノシズカ
もひ	モヒ
もみ	モミ
もみの木	モミノキ
もも	モモ
もやし	モヤシ
もよう	モヨウ
もろ	モロ
もろ肌	モロハダ
もん	モン
もんか	モンカ
もんじゃ	モンジャ
も本	モホン
や	ヤ
やあ	ヤア
やおや	ヤオヤ
やから	ヤカラ
やきそば	ヤキソバ
やきとり	ヤキトリ
やくざ	ヤクザ
やく本	ヤクホン
やぐら	ヤグラ
やけ	ヤケ
やけど	ヤケド
やご	ヤゴ
やしません	ヤシマセン
やす	ヤス
やっかい	ヤッカイ
やっこ	ヤッコ
やっとこ	ヤットコ
やつ	ヤツ
やな	ヤナ
やまいも	ヤマイモ
やまもも	ヤマモモ
やみ	ヤミ
やめ	ヤメ
やもう	ヤモウ
やらないか	ヤラナイカ
やらないから	ヤラナイカラ
やりど	ヤリド
やり口	ヤリクチ
やり場	ヤリバ
やり方	ヤリカタ
やる気	ヤルキ
やれ	ヤレ
やろう	ヤロウ
やんちゃ	ヤンチャ
や行	ヤギョウ
ゆ	ユ
ゆうべ	ユウベ
ゆえ	ユエ
ゆかり	ユカリ
ゆかん	ユカン
ゆき	ユキ
ゆきおんな	ユキオンナ
ゆず	ユズ
ゆずこしょう	ユズコショウ
ゆるし	ユルシ
ゆるやか	ユルヤカ
よいよい	ヨイヨイ
よう	ヨウ
ようかん	ヨウカン
ようやく	ヨウヤク
よく槽	ヨクソウ
よけい	ヨケイ
よごれ	ヨゴレ
よし	ヨシ
よし水	ヨシミズ
よせばいいのに	ヨセバイイノニ
よそ	ヨソ
よそ目	ヨソメ
よだつ	ヨダツ
よっぽど	ヨッポド
よどみ	ヨドミ
よみ	ヨミ
よみで	ヨミデ
よもぎ	ヨモギ
よりまし	ヨリマシ
よれよれ	ヨレヨレ
ら	ラ
らい	ライ
らいい	ライイ
らいち	ライチ
らいてい	ライテイ
らいむ	ライム
らい者	ライシャ
らく	ラク
らげ	ラゲ
らし	ラシ
らしくない	ラシクナイ
らす	ラス
らずべりー	ラズベリー
らっきょう	ラッキョウ
らっこ	ラッコ
らな	ラナ
らめ	ラメ
らん	ラン
らんぶ	ランブ
らん方	ランポウ
ら・ふらんす	ラフランス
らーめん	ラーメン
ら行	ラギョウ
りか	リカ
りさ	リサ
りし	リシ
りそう	リソウ
りっしんべん	リッシンベン
りな	リナ
りの	リノ
りま	リマ
りみ	リミ
りょう	リョウ
りり	リリ
りる	リル
りんご	リンゴ
りんご酢	リンゴス
りんどう	リンドウ
り上	リアゲ
り下	リカ
り付	リツキ
り外	リガイ
り方	リカタ
るい	ルイ
るいん	ルイン
るか	ルカ
るし	ルシ
るす	ルス
るん	ルン
る説	ルセツ
れあ	レア
れい	レイ
れっど	レッド
れつい	レツイ
れも	レモ
れもん	レモン
れんか	レンカ
れんこん	レンコン
れんさ	レンサ
ろ	ロ
ろいろ	ロイロ
ろう	ロウ
ろうと	ロウト
ろう苦	ロウク
ろか	ロカ
ろれつ	ロレツ
ろん	ロン
ろー	ロー
ろーぷ	ロープ
わ	ワ
わい	ワイ
わいる	ワイル
わからん	ワカラン
わかり	ワカリ
わがまま	ワガママ
わが子よ	ワガコヨ
わが家	ワガヤ
わが宿	ワガヤド
わが物顔	ワガモノガオ
わが身	ワガミ
わき	ワキ
わく	ワク
わけ	ワケ
わけぎ	ワケギ
わさび	ワサビ
わざ	ワザ
わし	ワシ
わたくし	ワタクシ
わたし	ワタシ
わたしたち	ワタシタチ
わたしゃ	ワタシャ
わら	ワラ
わらしべ長者	ワラシベチョウジャ
わらび	ワラビ
わらびもち	ワラビモチ
わらび餅	ワラビモチ
わり	ワリ
わる	ワル
わる者	ワルモノ
われ	ワレ
われがち	ワレガチ
われら	ワレラ
われわれ	ワレワレ
わ行	ワギョウ
ん	ン
アイ	アイ
アイアイ	アイアイ
アイス	アイス
アイスまんじゅう	アイスマンジュウ
アイスクリーム	アイスクリーム
アイソクラチス	アイソクラチス
アイナメ	アイナメ
アイロニー	アイロニー
アオイ	アオイ
アオキ	アオキ
アオダモ	アオダモ
アオハダ	アオハダ
アカエイ	アカエイ
アカギツネ	アカギツネ
アカシデ	アカシデ
アカネズミ	アカネズミ
アカハタ	アカハタ
アカマツ	アカマツ
アカムツ	アカムツ
アカンサス	アカンサス
アキ	アキ
アクセント	アクセント
アケビ	アケビ
アサガオ	アサガオ
アサダ	アサダ
アサノハカエデ	アサノハカエデ
アザミ	アザミ
アザラシ	アザラシ
アシカ	アシカ
アジ	アジ
アジアゾウ	アジアゾウ
アジサイ	アジサイ
アスダロ	アスダロ
アスナロ	アスナロ
アスパラガス	アスパラガス
アスヒ	アスヒ
アズマモグラ	アズマモグラ
アセチレンランプ	アセチレンランプ
アセロラ	アセロラ
アダム	アダム
アップル	アップル
アップルパイ	アップルパイ
アツモリソウ	アツモリソウ
アテビ	アテビ
アテモヤ	アテモヤ
アトリエ	アトリエ
アナウサギ	アナウサギ
アナコンダ	アナコンダ
アナゴ	アナゴ
アニメ	アニメ
アネサ	アネサ
アネモネ	アネモネ
アハ	アハ
アハハハ	アハハハ
アハハハハ	アハハハハ
アハハハハハ	アハハハハハ
アパート	アパート
アヒル	アヒル
アフリカゾウ	アフリカゾウ
アフリカタテガミヤマアラシ	アフリカタテガミヤマアラシ
アブ	アブ
アブサン	アブサン
アブラコウモリ	アブラコウモリ
アブラナ	アブラナ
アブラハヤ	アブラハヤ
アブラボウズ	アブラボウズ
アプリコット	アプリコット
アボカド	アボカド
アボガド	アボガド
アポロ	アポロ
アマチュア	アマチュア
アマミノクロウサギ	アマミノクロウサギ
アマリリス	アマリリス
アムビション	アムビション
アメマス	アメマス
アメリカ	アメリカ
アメリカバイソン	アメリカバイソン
アメリカビーバー	アメリカビーバー
アメリカマナティー	アメリカマナティー
アメリカンチェリー	アメリカンチェリー
アメンボ	アメンボ
アヤメ	アヤメ
アユ	アユ
アユカケ	アユカケ
アラ	アラ
アライグマ	アライグマ
アラカブ	アラカブ
アリ	アリ
アリクイ	アリクイ
アリストートル	アリストートル
アルコール	アルコール
アルコールラムプ	アルコールラムプ
アルコール中毒	アルコールチュウドク
アルストロメリア	アルストロメリア
アルバム	アルバム
アルパカ	アルパカ
アルビレオ	アルビレオ
アルフォート	アルフォート
アルプス	アルプス
アルプスマーモット	アルプスマーモット
アルマジロ	アルマジロ
アル中	アルチュウ
アレキサンダー	アレキサンダー
アロワナ	アロワナ
アングロサクソン民族	アングロサクソンミンゾク
アンコウ	アンコウ
アンコール	アンコール
アンズ	アンズ
アンチピリン	アンチピリン
アンチモニー	アンチモニー
アンチョビソース	アンチョビソース
アンデス	アンデス
アンデスメロン	アンデスメロン
アント	アント
アントニム	アントニム
アンドレ	アンドレ
アンドレア・デル・サルト	アンドレアデルサルト
アーキミジス	アーキミジス
アーメン	アーメン
アーモンド	アーモンド
アールスメロン	アールスメロン
イエイヌ	イエイヌ
イエコウモリ	イエコウモリ
イエス	イエス
イエネコ	イエネコ
イカ	イカ
イカサマ師	イカサマシ
イゴイスト	イゴイスト
イサイフミ	イサイフミ
イサキ	イサキ
イスキラス	イスキラス
イスノキ	イスノキ
イタチ	イタチ
イタヤカエデ	イタヤカエデ
イタリアンドレッシング	イタリアンドレッシング
イチイ	イチイ
イチゴ	イチゴ
イチジク	イチジク
イチョウ	イチョウ
イッテンフエダイ	イッテンフエダイ
イトスギ	イトスギ
イトヒバ	イトヒバ
イナゴ	イナゴ
イヌ	イヌ
イヌガヤ	イヌガヤ
イヌシデ	イヌシデ
イヌツゲ	イヌツゲ
イヌブナ	イヌブナ
イヌマキ	イヌマキ
イノシシ	イノシシ
イブキトラノオ	イブキトラノオ
イボイノシシ	イボイノシシ
イボタノキ	イボタノキ
イモリ	イモリ
イヤ	イヤ
イヨー	イヨー
イラクサ	イラクサ
イルカ	イルカ
イワシ	イワシ
イワシクジラ	イワシクジラ
イワナ	イワナ
インク	インク
インクカートリッジ	インクカートリッジ
インコ	インコ
インスピレーション	インスピレーション
インターネット	インターネット
インデアン	インデアン
インデックス	インデックス
インデヤン	インデヤン
インド	インド
インドゾウ	インドゾウ
インパラ	インパラ
ウィキペディア	ウィキペディア
ウィッチ	ウィッチ
ウィルヒョウ	ウィルヒョウ
ウェア	ウェア
ウェブスター	ウェブスター
ウェルテル	ウェルテル
ウエハース	ウエハース
ウグイ	ウグイ
ウコギ	ウコギ
ウコギ科	ウコギカ
ウサギ	ウサギ
ウシ	ウシ
ウスターソース	ウスターソース
ウソ	ウソ
ウダイカンバ	ウダイカンバ
ウッドチャック	ウッドチャック
ウツボ	ウツボ
ウナギ	ウナギ
ウバザメ	ウバザメ
ウバメガシ	ウバメガシ
ウフフフフ	ウフフフフ
ウフン	ウフン
ウマ	ウマ
ウマヅラハギ	ウマヅラハギ
ウミウシ	ウミウシ
ウミガメ	ウミガメ
ウム	ウム
ウメ	ウメ
ウメモドキ	ウメモドキ
ウラジロノキ	ウラジロノキ
ウリノキ	ウリノキ
ウルシ	ウルシ
ウワミズザクラ	ウワミズザクラ
ウンピョウ	ウンピョウ
エクレア	エクレア
エゴイスト	エゴイスト
エゴイズム	エゴイズム
エゴノキ	エゴノキ
エジプト	エジプト
エジプト人	エジプトジン
エゾエンゴサク	エゾエンゴサク
エゾマツ	エゾマツ
エゾヤマザクラ	エゾヤマザクラ
エゾリス	エゾリス
エゾルリムラサキ	エゾルリムラサキ
エビ	エビ
エビチリ	エビチリ
エビフライ	エビフライ
エピクテタス	エピクテタス
エピローグ	エピローグ
エヘッ	エヘッ
エヘヘヘ	エヘヘヘ
エヘヘヘヘ	エヘヘヘヘ
エヘン	エヘン
エホバ	エホバ
エミュー	エミュー
エリザベス	エリザベス
エルリントン	エルリントン
エンジュ	エンジュ
エーデルワイス	エーデルワイス
オイオイ	オイオイ
オイカワ	オイカワ
オイスターソース	オイスターソース
オウゴン	オウゴン
オウシュウトウヒ	オウシュウトウヒ
オウム	オウム
オオアリクイ	オオアリクイ
オオイヌノフグリ	オオイヌノフグリ
オオウラジロノキ	オオウラジロノキ
オオカミ	オオカミ
オオカメノキ	オオカメノキ
オオカンガルー	オオカンガルー
オオガハス	オオガハス
オオハンゴンソウ	オオハンゴンソウ
オオバコ	オオバコ
オオバナノエンレイソウ	オオバナノエンレイソウ
オオバヤドリギ	オオバヤドリギ
オオバヤナギ	オオバヤナギ
オオミツルコケモモ	オオミツルコケモモ
オオモンハタ	オオモンハタ
オカピー	オカピー
オガタマノキ	オガタマノキ
オグロプレーリードッグ	オグロプレーリードッグ
オコゼ	オコゼ
オスカー	オスカー
オタ	オタ
オタンチン	オタンチン
オットセイ	オットセイ
オディセー	オディセー
オトギリソウ	オトギリソウ
オトメユリ	オトメユリ
オナガザル	オナガザル
オニイトマキエイ	オニイトマキエイ
オニオンドレッシング	オニオンドレッシング
オニカサゴ	オニカサゴ
オニグルミ	オニグルミ
オニシバリ	オニシバリ
オヒョウ	オヒョウ
オホホホホホ	オホホホホホ
オポッサム	オポッサム
オマキザル	オマキザル
オムライス	オムライス
オムレツ	オムレツ
オランウータン	オランウータン
オリムパス	オリムパス
オリーブ	オリーブ
オリーブオイル	オリーブオイル
オレオ	オレオ
オレガノ	オレガノ
オレンジ	オレンジ
オンシジウム	オンシジウム
オンシジューム	オンシジューム
オント	オント
オンバ	オンバ
オーケストラ	オーケストラ
カイゼル	カイゼル
カイヅカイブキ	カイヅカイブキ
カエデ	カエデ
カエル	カエル
カカオ	カカオ
カキ	カキ
カキツバタ	カキツバタ
カキノキ	カキノキ
カキノキ科	カキノキカ
カキフライ	カキフライ
カクレクマノミ	カクレクマノミ
カクレミノ	カクレミノ
カゴ	カゴ
カサゴ	カサゴ
カサブランカ	カサブランカ
カシス	カシス
カシューナッツ	カシューナッツ
カスザメ	カスザメ
カスタード	カスタード
カステラ	カステラ
カスミザクラ	カスミザクラ
カゼ	カゼ
カタカナ語	カタカナゴ
カタクリ	カタクリ
カタバミ	カタバミ
カチッカチッ	カチッカチッ
カッター	カッター
カッターマット	カッターマット
カッティングマット	カッティングマット
カット	カット
カツオ	カツオ
カツオクジラ	カツオクジラ
カツカレー	カツカレー
カツラ	カツラ
カツレツ	カツレツ
カツ丼	カツドン
カトウ	カトウ
カトリック	カトリック
カトレア	カトレア
カナダ	カナダ
カナメモチ	カナメモチ
カナリア	カナリア
カニ	カニ
カネコリムスメ	カネコリムスメ
カノコユリ	カノコユリ
カバ	カバ
カバノキ	カバノキ
カピバラ	カピバラ
カフェ	カフェ
カフエ	カフエ
カフス	カフス
カブの葉	カブノハ
カブトガニ	カブトガニ
カブトムシ	カブトムシ
カプレーゼ	カプレーゼ
カボチャ	カボチャ
カマキリ	カマキリ
カマクラヒバ	カマクラヒバ
カマス	カマス
カマド	カマド
カマドウマ	カマドウマ
カミナリ	カミナリ
カムパネルラ	カムパネルラ
カメ	カメ
カモ	カモ
カモノハシ	カモノハシ
カヤ	カヤ
カラ	カラ
カラオケ	カラオケ
カラオケボックス	カラオケボックス
カラクリ	カラクリ
カラス	カラス
カラスシキミ	カラスシキミ
カラスノエンドウ	カラスノエンドウ
カラタチ	カラタチ
カラマツ	カラマツ
カラント	カラント
カリフォルニアアシカ	カリフォルニアアシカ
カリフラワー	カリフラワー
カリン	カリン
カルシウム	カルシウム
カルダモン	カルダモン
カルボナーラ	カルボナーラ
カルメ焼き	カルメヤキ
カルモチン	カルモチン
カレイ	カレイ
カレンダー	カレンダー
カレー	カレー
カレーうどん	カレーウドン
カレーパン	カレーパン
カレーライス	カレーライス
カレー粉	カレーコ
カワウソ	カワウソ
カワセミ	カワセミ
カワハギ	カワハギ
カワヤツメ	カワヤツメ
カンガルー	カンガルー
カンサイタンポポ	カンサイタンポポ
カンタロープ	カンタロープ
カンツバキ	カンツバキ
カントウタンポポ	カントウタンポポ
カンパチ	カンパチ
カード	カード
カードケース	カードケース
カードゲーム	カードゲーム
カーネーション	カーネーション
カーボン紙	カーボンシ
カーライル	カーライル
カール	カール
カ所	カショ
カ月	カゲツ
ガ	ガ
ガゼル	ガゼル
ガタリ	ガタリ
ガチョウ	ガチョウ
ガパオライス	ガパオライス
ガマズミ	ガマズミ
ガムテープ	ガムテープ
ガラクタ	ガラクタ
ガラス	ガラス
ガラムマサラ	ガラムマサラ
ガリガリ君	ガリガリクン
ガルガ	ガルガ
ガルボ	ガルボ
ガンプラ	ガンプラ
ガーデニング	ガーデニング
ガーベラ	ガーベラ
ガーリックソルト	ガーリックソルト
ガール	ガール
キイ	キイ
キイチゴ	キイチゴ
キウイ	キウイ
キウイフルーツ	キウイフルーツ
キキョウ	キキョウ
キク	キク
キザ	キザ
キシャゴ	キシャゴ
キス	キス
キタキツネ	キタキツネ
キタコブシ	キタコブシ
キットカット	キットカット
キツネ	キツネ
キツネザル	キツネザル
キヅタ	キヅタ
キト	キト
キヌ	キヌ
キハダ	キハダ
キムチ鍋	キムチナベ
キャッチボール	キャッチボール
キャノーラ油	キャノーラユ
キャベツ	キャベツ
キャラボク	キャラボク
キャラメル	キャラメル
キャンディ	キャンディ
キャンプ	キャンプ
キャンプファイヤー	キャンプファイヤー
キュウリ	キュウリ
キュー	キュー
キューピッド	キューピッド
キョウチクトウ	キョウチクトウ
キョロキョロ	キョロキョロ
キリ	キリ
キリン	キリン
キンイブキ	キンイブキ
キンカン	キンカン
キンギョ	キンギョ
キンシコウ	キンシコウ
キンシバイ	キンシバイ
キンセンカ	キンセンカ
キンタ	キンタ
キンチャクダイ	キンチャクダイ
キンポウゲ	キンポウゲ
キンポウゲ科	キンポウゲカ
キンメダイ	キンメダイ
キンモクセイ	キンモクセイ
キ属	キゾク
ギボン	ギボン
ギャー	ギャー
ギンザケ	ギンザケ
ギンダラ	ギンダラ
ギンブナ	ギンブナ
ギンモクセイ	ギンモクセイ
ギーギーフーギーギーフー	ギーギーフーギーギーフー
クイズ	クイズ
クインシー	クインシー
クエ	クエ
クジャク	クジャク
クジャクヒバ	クジャクヒバ
クジラ	クジラ
クジラウオ	クジラウオ
クスノキ	クスノキ
クスノキ科	クスノキカ
クズ	クズ
クソミソ	クソミソ
クッキー	クッキー
クヌギ	クヌギ
クマ	クマ
クマガイソウ	クマガイソウ
クマシデ	クマシデ
クマツヅラ科	クマツヅラカ
クマネズミ	クマネズミ
クミン	クミン
クラゲ	クラゲ
クラス	クラス
クラッカー	クラッカー
クラブ	クラブ
クラムチャウダー	クラムチャウダー
クララ	クララ
クランチ	クランチ
クランベリー	クランベリー
クリ	クリ
クリア	クリア
クリアファイル	クリアファイル
クリシッパス	クリシッパス
クリス	クリス
クリスチャン	クリスチャン
クリスト	クリスト
クリスマス	クリスマス
クリップ	クリップ
クリップボード	クリップボード
クリーサス	クリーサス
クリームあんみつ	クリームアンミツ
クリームシチュー	クリームシチュー
クルミ	クルミ
クレオパトラ	クレオパトラ
クレソン	クレソン
クレパス	クレパス
クレマチス	クレマチス
クレヨン	クレヨン
クレープ	クレープ
クロウメモドキ	クロウメモドキ
クロキツネザル	クロキツネザル
クロサイ	クロサイ
クロスグリ	クロスグリ
クロダイ	クロダイ
クロッカス	クロッカス
クロパトキン	クロパトキン
クロベ	クロベ
クロマグロ	クロマグロ
クロマツ	クロマツ
クロミノウグイスカグラ	クロミノウグイスカグラ
クロムツ	クロムツ
クロユリ	クロユリ
クロワッサン	クロワッサン
クロンキスト体系	クロンキストタイケイ
クローブ	クローブ
クワ	クワ
クワガタ	クワガタ
グアバ	グアバ
グッピー	グッピー
グミ	グミ
グラジオラス	グラジオラス
グラタン	グラタン
グリズリー	グリズリー
グリーン	グリーン
グリーンカレー	グリーンカレー
グルウプ	グルウプ
グルメ	グルメ
グレー	グレー
グレープフルーツ	グレープフルーツ
グーズベリー	グーズベリー
グード	グード
ケイトウ	ケイトウ
ケシ	ケシ
ケショウヤナギ	ケショウヤナギ
ケチ	ケチ
ケチャップ	ケチャップ
ケチャップマニス	ケチャップマニス
ケット	ケット
ケニルウォース	ケニルウォース
ケヤキ	ケヤキ
ケンサキイカ	ケンサキイカ
ケンタウル	ケンタウル
ケンタウルス	ケンタウルス
ケンポナシ	ケンポナシ
ケーキ	ケーキ
ケース	ケース
ケート	ケート
ケーブルテレビ	ケーブルテレビ
ケーブルテレビ局	ケーブルテレビキョク
ケール	ケール
ゲッカコウ	ゲッカコウ
ゲッキツ	ゲッキツ
ゲッケイジュ	ゲッケイジュ
ゲンゴロウ	ゲンゴロウ
ゲンゴロウブナ	ゲンゴロウブナ
ゲンマン	ゲンマン
ゲー	ゲー
ゲーム	ゲーム
ゲーム実況	ゲームジッキョウ
ゲーレン	ゲーレン
コアラ	コアラ
コアラのマーチ	コアラノマーチ
コイ	コイ
コイワシクジラ	コイワシクジラ
コウゾ	コウゾ
コウモリ	コウモリ
コウヤマキ	コウヤマキ
コウヨウザン	コウヨウザン
コウリンタンポポ	コウリンタンポポ
コオロギ	コオロギ
コクタン	コクタン
コクワ	コクワ
コケモモ	コケモモ
ココナッツ	ココナッツ
コシアブラ	コシアブラ
コショウ	コショウ
コショウノキ	コショウノキ
コスプレ	コスプレ
コスメチック	コスメチック
コスモス	コスモス
コセ	コセ
コセコセ	コセコセ
コチュジャン	コチュジャン
コップ	コップ
コナラ	コナラ
コノテガシワ	コノテガシワ
コハウチワカエデ	コハウチワカエデ
コビトカバ	コビトカバ
コビトキツネザル	コビトキツネザル
コピイ	コピイ
コピー用紙	コピーヨウシ
コブシ	コブシ
コブラ	コブラ
コマクサ	コマクサ
コマユミ	コマユミ
コミネカエデ	コミネカエデ
コム	コム
コムラサキ	コムラサキ
コメ	コメ
コメディー	コメディー
コヨーテ	コヨーテ
コリアンダー	コリアンダー
コリドラス	コリドラス
コルク	コルク
コロッケ	コロッケ
コロラド	コロラド
コロンバス	コロンバス
コン	コン
コンサート	コンサート
コンソメ	コンソメ
コンネクテカット	コンネクテカット
コンパス	コンパス
コンボウ	コンボウ
コードギアス	コードギアス
コーヒー	コーヒー
コーラ	コーラ
コーラン	コーラン
コーンスープ	コーンスープ
ゴシゴシゴシ	ゴシゴシゴシ
ゴシック	ゴシック
ゴッホ	ゴッホ
ゴホン	ゴホン
ゴマ	ゴマ
ゴマキ	ゴマキ
ゴマノハグサ	ゴマノハグサ
ゴム	ゴム
ゴリラ	ゴリラ
ゴルキ	ゴルキ
ゴレンシ	ゴレンシ
ゴロ	ゴロ
ゴワゴワ	ゴワゴワ
ゴーギャン	ゴーギャン
ゴーヤ	ゴーヤ
ゴーヤチャンプルー	ゴーヤチャンプルー
ゴールデン	ゴールデン
ゴールデンハムスター	ゴールデンハムスター
ゴールドスミス	ゴールドスミス
サ	サ
サイ	サイ
サイカチ	サイカチ
サイト	サイト
サイプレス	サイプレス
サインペン	サインペン
サウザンアイランド	サウザンアイランド
サウザンクロス	サウザンクロス
サウナ	サウナ
サカ	サカ
サカキ	サカキ
サクラ	サクラ
サクラソウ	サクラソウ
サクランボ	サクランボ
サケ	サケ
サケガシラ	サケガシラ
サゴシ	サゴシ
サザンカ	サザンカ
サジー	サジー
サタン	サタン
サツキ	サツキ
サトウカエデ	サトウカエデ
サナトリアム	サナトリアム
サニーレタス	サニーレタス
サバ	サバ
サバンナシマウマ	サバンナシマウマ
サファイア	サファイア
サフラン	サフラン
サフランモドキ	サフランモドキ
サブレ	サブレ
サポジラ	サポジラ
サム	サム
サムギョプサル	サムギョプサル
サメ	サメ
サヨリ	サヨリ
サラサドウダン	サラサドウダン
サラダ	サラダ
サラダ油	サラダユ
サラダ菜	サラダナ
サラリイマン	サラリイマン
サル	サル
サルスベリ	サルスベリ
サルナシ	サルナシ
サルビア	サルビア
サロン	サロン
サワグルミ	サワグルミ
サワシバ	サワシバ
サワラ	サワラ
サン	サン
サンシュユ	サンシュユ
サンショウ	サンショウ
サンショウウオ	サンショウウオ
サンド	サンド
サンドイッチ	サンドイッチ
サンマ	サンマ
サーチ	サーチ
サーバル	サーバル
ザウエル	ザウエル
ザクロ	ザクロ
ザゼンソウ	ザゼンソウ
ザトウクジラ	ザトウクジラ
ザネリ	ザネリ
シ	シ
シイノキ	シイノキ
シイラ	シイラ
シカ	シカ
シガマニョウボウ	シガマニョウボウ
シクラメン	シクラメン
シグナル	シグナル
シゲちゃん	シゲチャン
シゲ子	シゲコ
シコンノボタン	シコンノボタン
シシマイ	シシマイ
シジュウカラ	シジュウカラ
シソ	シソ
シタン	シタン
シタン属	シタンゾク
シダレヤナギ	シダレヤナギ
シチュ	シチュ
シッペ	シッペ
シヅ子	シヅコ
シドニー・スミス	シドニースミス
シナナシ	シナナシ
シナノキ	シナノキ
シナノキ科	シナノキカ
シナモン	シナモン
シノニム	シノニム
シマアジ	シマアジ
シマウマ	シマウマ
シマドジョウ	シマドジョウ
シマリス	シマリス
シモクレン	シモクレン
シモツケ	シモツケ
シモニジス	シモニジス
シャインマスカット	シャインマスカット
シャクナゲ	シャクナゲ
シャクヤク	シャクヤク
シャチ	シャチ
シャチハタ	シャチハタ
シャツ	シャツ
シャリンバイ	シャリンバイ
シャンパン	シャンパン
シャープペンシル	シャープペンシル
シャーレ	シャーレ
シュウマイ	シュウマイ
シュウメイギク	シュウメイギク
シュエデンボルグ	シュエデンボルグ
シュモクザメ	シュモクザメ
シューアイス	シューアイス
シュークリーム	シュークリーム
ショコラ	ショコラ
ショック	ショック
ショッピング	ショッピング
ショートケーキ	ショートケーキ
シラカシ	シラカシ
シラカバ	シラカバ
シラクチズル	シラクチズル
シラユリ	シラユリ
シラン	シラン
シロイルカ	シロイルカ
シロギス	シロギス
シロクマ	シロクマ
シロサイ	シロサイ
シロサケ	シロサケ
シロツメクサ	シロツメクサ
シロテテナガザル	シロテテナガザル
シロナガスクジラ	シロナガスクジラ
シンビジウム	シンビジウム
シンビジューム	シンビジューム
シンフォニー	シンフォニー
シンボル	シンボル
シークヮーサー	シークヮーサー
シーザー	シーザー
シーザーサラダ	シーザーサラダ
シーザードレッシング	シーザードレッシング
シーシー	シーシー
シーバックソーン	シーバックソーン
シーベリー	シーベリー
シーラカンス	シーラカンス
シール	シール
ジアスターゼ	ジアスターゼ
ジアール	ジアール
ジェノベーゼ	ジェノベーゼ
ジェノベーゼソース	ジェノベーゼソース
ジェームス	ジェームス
ジストマ	ジストマ
ジャイアントパンダ	ジャイアントパンダ
ジャガー	ジャガー
ジャケツ	ジャケツ
ジャコウネコ	ジャコウネコ
ジャスミン	ジャスミン
ジャッカル	ジャッカル
ジャックフルーツ	ジャックフルーツ
ジャパニーズ	ジャパニーズ
ジャパン	ジャパン
ジャム	ジャム
ジャン	ジャン
ジャンル	ジャンル
ジヤスターゼ	ジヤスターゼ
ジュ	ジュ
ジュゴン	ジュゴン
ジュピター	ジュピター
ジュリアス・シーザー	ジュリアスシーザー
ジュース	ジュース
ジューンベリー	ジューンベリー
ジョギング	ジョギング
ジョナゴールド	ジョナゴールド
ジョバンニ	ジョバンニ
ジロフォン	ジロフォン
ジンチョウゲ	ジンチョウゲ
ジンベエザメ	ジンベエザメ
スイカズラ	スイカズラ
スイショウ	スイショウ
スイセン	スイセン
スイリュウヒバ	スイリュウヒバ
スイレン	スイレン
スイート	スイート
スイートコーン	スイートコーン
スイートソップ	スイートソップ
スイートチリソース	スイートチリソース
スカラー	スカラー
スカンク	スカンク
スギ	スギ
スギ属	スギゾク
スクラップブック	スクラップブック
スクランブルエッグ	スクランブルエッグ
スグリ	スグリ
スケジュール	スケジュール
スケッチ	スケッチ
スケッチブック	スケッチブック
スコープ	スコープ
スズカケノキ	スズカケノキ
スズキ	スズキ
スズメ	スズメ
スズメダイ	スズメダイ
スズラン	スズラン
スズランズイセン	スズランズイセン
スタビリチー	スタビリチー
スタンド	スタンド
スタンプ	スタンプ
スタンプ台	スタンプダイ
スタンラン	スタンラン
スター	スター
スターフルーツ	スターフルーツ
スターン	スターン
スダチ	スダチ
スチール	スチール
スッポコポンノポン	スッポコポンノポン
スッポン	スッポン
スティッカー	スティッカー
スティックのり	スティックノリ
ステッカー	ステッカー
ステッキ	ステッキ
ステテコ	ステテコ
ステーキ	ステーキ
ステーション	ステーション
ステープラー	ステープラー
ストライキ	ストライキ
ストーブ	ストーブ
ストーリー	ストーリー
スナック菓子	スナックガシ
スナップえんどう	スナップエンドウ
スノ	スノ
スノーフレーク	スノーフレーク
スパゲッティ	スパゲッティ
スピノサスモモ	スピノサスモモ
スピリット	スピリット
スペイン	スペイン
スポイル	スポイル
スポーツ観戦	スポーツカンセン
スマ	スマ
スミス	スミス
スミミザクラ	スミミザクラ
スミレ	スミレ
スモモ	スモモ
スリ	スリ
スルメイカ	スルメイカ
スロット	スロット
スー	スー
スープ	スープ
ズッキーニ	ズッキーニ
ズック	ズック
ズボン	ズボン
ズーズー	ズーズー
セイウチ	セイウチ
セイヨウイチイ	セイヨウイチイ
セイヨウウスユキソウ	セイヨウウスユキソウ
セイヨウカリン	セイヨウカリン
セイヨウタンポポ	セイヨウタンポポ
セイヨウハコヤナギ	セイヨウハコヤナギ
セイヨウハシバミ	セイヨウハシバミ
セイロンニッケイ	セイロンニッケイ
セエター	セエター
セオファーノ	セオファーノ
セクスピヤ	セクスピヤ
セコイア	セコイア
セコイアデンドロン	セコイアデンドロン
セザンヌ	セザンヌ
セッちゃん	セッチャン
セッカチピンチャン	セッカチピンチャン
セット	セット
セネカ	セネカ
セピヤ	セピヤ
セミ	セミ
セミクジラ	セミクジラ
セリ	セリ
セルリー	セルリー
セロハンテープ	セロハンテープ
セロリ	セロリ
セン	セン
センリョウ	センリョウ
セージ	セージ
ゼ	ゼ
ゼニガタアザラシ	ゼニガタアザラシ
ゼムクリップ	ゼムクリップ
ゼラニウム	ゼラニウム
ゼリー	ゼリー
ゼームス	ゼームス
ソウダガツオ	ソウダガツオ
ソクラチス	ソクラチス
ソップ	ソップ
ソフォクリス	ソフォクリス
ソフト	ソフト
ソフトウェア	ソフトウェア
ソフトクリーム	ソフトクリーム
ソメイヨシノ	ソメイヨシノ
ソルト	ソルト
ソース	ソース
ゾウ	ゾウ
ゾラ	ゾラ
タイ	タイ
タイプ	タイプ
タイヘイヨウイチイ	タイヘイヨウイチイ
タイム	タイム
タイムカード	タイムカード
タイムス	タイムス
タイリクオオカミ	タイリクオオカミ
タイリクスズキ	タイリクスズキ
タイワン	タイワン
タカ	タカ
タカジヤスターゼ	タカジヤスターゼ
タカノツメ	タカノツメ
タガヤサン	タガヤサン
タコ	タコ
タコクラゲ	タコクラゲ
タスマニアデビル	タスマニアデビル
タダ	タダ
タチウオ	タチウオ
タック	タック
タッチ	タッチ
タナゴ	タナゴ
タニウツギ	タニウツギ
タヌキ	タヌキ
タバスコ	タバスコ
タマイブキ	タマイブキ
タマリンド	タマリンド
タムシバ	タムシバ
タラ	タラ
タラの芽	タラノメ
タラノキ	タラノキ
タラヨウ	タラヨウ
タルト	タルト
タンポポ	タンポポ
ターナー	ターナー
ターメリック	ターメリック
ダイアモンド	ダイアモンド
ダイオジニス	ダイオジニス
ダイヤモンド	ダイヤモンド
ダケカンバ	ダケカンバ
ダチョウ	ダチョウ
ダツ	ダツ
ダブル	ダブル
ダム	ダム
ダムダム弾	ダムダムダン
ダメ	ダメ
ダリア	ダリア
ダルベルギア	ダルベルギア
ダンス	ダンス
ダンビラ	ダンビラ
ダーク	ダーク
ダース	ダース
チイズ	チイズ
チェス	チェス
チェリモヤ	チェリモヤ
チェリー	チェリー
チキンカツ	チキンカツ
チコリ	チコリ
チゴ	チゴ
チゴユリ	チゴユリ
チシマザクラ	チシマザクラ
チスイコウモリ	チスイコウモリ
チドリノキ	チドリノキ
チヌ	チヌ
チャッカリ	チャッカリ
チャップ	チャップ
チャノキ	チャノキ
チャボ	チャボ
チャボヒバ	チャボヒバ
チャン	チャン
チャンポン	チャンポン
チャーシュー	チャーシュー
チャーハン	チャーハン
チュウゴクナシ	チュウゴクナシ
チュー	チュー
チューペット	チューペット
チューリップ	チューリップ
チョウ	チョウ
チョウチョウウオ	チョウチョウウオ
チョコ	チョコ
チョコバー	チョコバー
チョコパイ	チョコパイ
チョコレート	チョコレート
チョン髷	チョンマゲ
チョーク	チョーク
チリソース	チリソース
チリパウダー	チリパウダー
チリリリリン	チリリリリン
チリン	チリン
チロルチョコ	チロルチョコ
チンアナゴ	チンアナゴ
チンゲンサイ	チンゲンサイ
チンチラ	チンチラ
チンパンジー	チンパンジー
チンポ	チンポ
チー	チー
チーズおかき	チーズオカキ
チーズケーキ	チーズケーキ
チーズタルト	チーズタルト
チーズフォンデュ	チーズフォンデュ
チーター	チーター
チーン	チーン
ッ	ッ
ット	ット
ツァイシング	ツァイシング
ツインクル	ツインクル
ツガ	ツガ
ツキ	ツキ
ツキノワグマ	ツキノワグマ
ツケ	ツケ
ツタウルシ	ツタウルシ
ツチブタ	ツチブタ
ツツジ	ツツジ
ツナサラダ	ツナサラダ
ツネ子	ツネコ
ツノダシ	ツノダシ
ツノハシバミ	ツノハシバミ
ツバキ	ツバキ
ツバメ	ツバメ
ツミ	ツミ
ツユ	ツユ
ツユクサ	ツユクサ
ツララオンナ	ツララオンナ
ツリバナ	ツリバナ
ツル	ツル
ツー	ツー
ツール	ツール
ティボウキナ	ティボウキナ
ティラミス	ティラミス
テキスト	テキスト
テツ	テツ
テナガザル	テナガザル
テリヤ	テリヤ
テレビ	テレビ
テレマカス	テレマカス
テン	テン
テングザル	テングザル
テンジクネズミ	テンジクネズミ
テントウムシ	テントウムシ
テンプレート	テンプレート
テン属	テンゾク
テーブル	テーブル
テープ	テープ
テープのり	テープノリ
テーベ	テーベ
テーマ	テーマ
テーマパーク	テーマパーク
ディスカス	ディスカス
ディル	ディル
デイジー	デイジー
デカダン	デカダン
デカルト	デカルト
デコポン	デコポン
デコレーション	デコレーション
デザート	デザート
デスク	デスク
デッサン	デッサン
デメニギス	デメニギス
デモスセニス	デモスセニス
デラウェア	デラウェア
データ	データ
トイフェルスドレック	トイフェルスドレック
トウ	トウ
トウィード	トウィード
トウカエデ	トウカエデ
トウガラシ	トウガラシ
トウヒ	トウヒ
トカゲ	トカゲ
トガサワラ	トガサワラ
トガリネズミ	トガリネズミ
トキワマンサク	トキワマンサク
トサミズキ	トサミズキ
トチ	トチ
トチノキ	トチノキ
トチメンボー	トチメンボー
トッポ	トッポ
トッポギ	トッポギ
トド	トド
トナカイ	トナカイ
トネリコ	トネリコ
トパース	トパース
トビウオ	トビウオ
トマト	トマト
トムヤムクン	トムヤムクン
トヨウケビメ	トヨウケビメ
トラ	トラ
トラウト	トラウト
トラフグ	トラフグ
トラブル	トラブル
トランプ	トランプ
トリイ	トリイ
トリカブト	トリカブト
トリュフ塩	トリュフシオ
トレー	トレー
トレーシングペーパー	トレーシングペーパー
トロイ	トロイ
トンカツ	トンカツ
トントン	トントン
トンボ	トンボ
トースト	トースト
ドア	ドア
ドイツ	ドイツ
ドウダンツツジ	ドウダンツツジ
ドキュメント	ドキュメント
ドクトル	ドクトル
ドサン	ドサン
ドジョウ	ドジョウ
ドスト	ドスト
ドストイエフスキイ	ドストイエフスキイ
ドテラ	ドテラ
ドブネズミ	ドブネズミ
ドライブ	ドライブ
ドラゴンフルーツ	ドラゴンフルーツ
ドラマ	ドラマ
ドリア	ドリア
ドリアン	ドリアン
ドル	ドル
ドレッシング	ドレッシング
ドンコ	ドンコ
ドーナツ	ドーナツ
ナイス	ナイス
ナイフ	ナイフ
ナガモチ	ナガモチ
ナシ	ナシ
ナス	ナス
ナズナ	ナズナ
ナッシ	ナッシ
ナッツ	ナッツ
ナツツバキ	ナツツバキ
ナツハゼ	ナツハゼ
ナツメ	ナツメ
ナツメグ	ナツメグ
ナツメヤシ	ナツメヤシ
ナデシコ	ナデシコ
ナナカマド	ナナカマド
ナニ	ナニ
ナニワズ	ナニワズ
ナビスコ	ナビスコ
ナボナ	ナボナ
ナポリタン	ナポリタン
ナポレオン	ナポレオン
ナポレオンフィッシュ	ナポレオンフィッシュ
ナマケモノ	ナマケモノ
ナマズ	ナマズ
ナン	ナン
ナンジャモンジャ	ナンジャモンジャ
ナンテン	ナンテン
ナンプラー	ナンプラー
ナンヨウスギ	ナンヨウスギ
ナンヨウハギ	ナンヨウハギ
ナール	ナール
ニシキギ	ニシキギ
ニシキベラ	ニシキベラ
ニシン	ニシン
ニジマス	ニジマス
ニセアカシア	ニセアカシア
ニッケイ	ニッケイ
ニッケル	ニッケル
ニッコウキスゲ	ニッコウキスゲ
ニホンザル	ニホンザル
ニホンジカ	ニホンジカ
ニホンモモンガ	ニホンモモンガ
ニホンリス	ニホンリス
ニャン	ニャン
ニャー	ニャー
ニヤケ	ニヤケ
ニュース	ニュース
ニュートン	ニュートン
ニラ	ニラ
ニレ	ニレ
ニワウメ	ニワウメ
ニワトリ	ニワトリ
ニンニク	ニンニク
ニーチェ	ニーチェ
ヌマスギ	ヌマスギ
ネオン	ネオン
ネオンサイン	ネオンサイン
ネオンテトラ	ネオンテトラ
ネギ	ネギ
ネクタイ	ネクタイ
ネクタリン	ネクタリン
ネコ	ネコ
ネコヤナギ	ネコヤナギ
ネジバナ	ネジバナ
ネズ	ネズ
ネズコ	ネズコ
ネズミ	ネズミ
ネムノキ	ネムノキ
ネモトシャクナゲ	ネモトシャクナゲ
ネモフィラ	ネモフィラ
ネーブルオレンジ	ネーブルオレンジ
ネームシール	ネームシール
ノアザミ	ノアザミ
ノウサギ	ノウサギ
ノッズル	ノッズル
ノドグロ	ノドグロ
ノバラ	ノバラ
ノボタン	ノボタン
ノヤギ	ノヤギ
ノリウツギ	ノリウツギ
ノルウェー	ノルウェー
ノンキ	ノンキ
ノート	ノート
ノートブック	ノートブック
ノーマル	ノーマル
ハイイロ	ハイイロ
ハイイロオオカミ	ハイイロオオカミ
ハイエナ	ハイエナ
ハイカラ	ハイカラ
ハイカラさん	ハイカラサン
ハイスクール	ハイスクール
ハイチュウ	ハイチュウ
ハイネズ	ハイネズ
ハイビスカス	ハイビスカス
ハイビャクシン	ハイビャクシン
ハイボール	ハイボール
ハイマツ	ハイマツ
ハウチワカエデ	ハウチワカエデ
ハギ	ハギ
ハクウンボク	ハクウンボク
ハクチョウ	ハクチョウ
ハクビシン	ハクビシン
ハクモクレン	ハクモクレン
ハコフグ	ハコフグ
ハコベ	ハコベ
ハコヤナギ	ハコヤナギ
ハシドイ	ハシドイ
ハシバミ	ハシバミ
ハス	ハス
ハスカップ	ハスカップ
ハゼ	ハゼ
ハタ	ハタ
ハタハタ	ハタハタ
ハチ	ハチ
ハッシュドビーフ	ハッシュドビーフ
ハッピーターン	ハッピーターン
ハツカネズミ	ハツカネズミ
ハト	ハト
ハナ	ハナ
ハナイカダ	ハナイカダ
ハナショウブ	ハナショウブ
ハナズオウ	ハナズオウ
ハナニラ	ハナニラ
ハナミズキ	ハナミズキ
ハナミノカサゴ	ハナミノカサゴ
ハネデューメロン	ハネデューメロン
ハハハ	ハハハ
ハハハハ	ハハハハ
ハハハハハ	ハハハハハ
ハハ御	ハハゴ
ハマギク	ハマギク
ハマナス	ハマナス
ハマヒサカキ	ハマヒサカキ
ハムスター	ハムスター
ハムレット	ハムレット
ハモ	ハモ
ハヤシライス	ハヤシライス
ハヤブサ	ハヤブサ
ハリエンジュ	ハリエンジュ
ハリギリ	ハリギリ
ハリセンボン	ハリセンボン
ハリソン	ハリソン
ハリネズミ	ハリネズミ
ハリモグラ	ハリモグラ
ハルジオン	ハルジオン
ハルニレ	ハルニレ
ハルレヤ	ハルレヤ
ハルレヤハルレヤ	ハルレヤハルレヤ
ハロルド・ロイド	ハロルドロイド
ハンギング	ハンギング
ハンケチ	ハンケチ
ハンドメイド	ハンドメイド
ハンニバル	ハンニバル
ハンノ	ハンノ
ハンノキ	ハンノキ
ハンバーガー	ハンバーガー
ハンバーグ	ハンバーグ
ハーキュリス	ハーキュリス
ハート	ハート
ハード	ハード
ハーブ	ハーブ
ハーブソルト	ハーブソルト
ハープ	ハープ
バア	バア
バイソン	バイソン
バイブル	バイブル
バインダー	バインダー
バウヒニア	バウヒニア
バウムクーヘン	バウムクーヘン
バオバブ	バオバブ
バク	バク
バクチノキ	バクチノキ
バケツ	バケツ
バジル	バジル
バジルソース	バジルソース
バス	バス
バタ	バタ
バター	バター
バッタ	バッタ
バット	バット
バッファロー	バッファロー
バトン	バトン
バナナ	バナナ
ババロア	ババロア
バラ	バラ
バラ科	バラカ
バリエーション	バリエーション
バルサミコ酢	バルサミコス
バルザック	バルザック
バルチック艦隊	バルチックカンタイ
バルドラ	バルドラ
バレンシアオレンジ	バレンシアオレンジ
バンディクート	バンディクート
バンド	バンド
バンドウイルカ	バンドウイルカ
バーベキュー	バーベキュー
パアトス	パアトス
パイ	パイ
パイの実	パイノミ
パイナップル	パイナップル
パイプ	パイプ
パインアップル	パインアップル
パウンドケーキ	パウンドケーキ
パクチー	パクチー
パサン	パサン
パシフィック	パシフィック
パス	パス
パスカル	パスカル
パスタ	パスタ
パステル	パステル
パセリ	パセリ
パターン	パターン
パチンコ	パチンコ
パッションフルーツ	パッションフルーツ
パッタイ	パッタイ
パッド	パッド
パナマ	パナマ
パパイヤ	パパイヤ
パプリカ	パプリカ
パプリカパウダー	パプリカパウダー
パラセルサス	パラセルサス
パラドックス	パラドックス
パルプ	パルプ
パレオロガス	パレオロガス
パレット	パレット
パン	パン
パンケーキ	パンケーキ
パンジー	パンジー
パンダ	パンダ
パンチ	パンチ
パンノキ	パンノキ
パンフレット	パンフレット
パンヤ	パンヤ
ヒ	ヒ
ヒイラギ	ヒイラギ
ヒイラギナンテン	ヒイラギナンテン
ヒオイ	ヒオイ
ヒガンバナ	ヒガンバナ
ヒグマ	ヒグマ
ヒサカキ	ヒサカキ
ヒッポファエ	ヒッポファエ
ヒツジ	ヒツジ
ヒト	ヒト
ヒトコブラクダ	ヒトコブラクダ
ヒトツバカエデ	ヒトツバカエデ
ヒトデ	ヒトデ
ヒナゲシ	ヒナゲシ
ヒノ	ヒノ
ヒノキ	ヒノキ
ヒバ	ヒバ
ヒマラヤスギ	ヒマラヤスギ
ヒマワリ	ヒマワリ
ヒメアヤメ	ヒメアヤメ
ヒメオドリコソウ	ヒメオドリコソウ
ヒメシャラ	ヒメシャラ
ヒメジョオン	ヒメジョオン
ヒメマス	ヒメマス
ヒヤシンス	ヒヤシンス
ヒヤヤヤ	ヒヤヤヤ
ヒュー	ヒュー
ヒョウ	ヒョウ
ヒョウタン	ヒョウタン
ヒラマサ	ヒラマサ
ヒラメ	ヒラメ
ヒルガオ	ヒルガオ
ヒント	ヒント
ビイル	ビイル
ビクーニャ	ビクーニャ
ビシソワーズ	ビシソワーズ
ビジネス	ビジネス
ビスケット	ビスケット
ビスコ	ビスコ
ビッグホーン	ビッグホーン
ビビンバ	ビビンバ
ビャクシン	ビャクシン
ビャクダン	ビャクダン
ビョウヤナギ	ビョウヤナギ
ビル	ビル
ビルベリー	ビルベリー
ビワ	ビワ
ビワモドキ亜綱	ビワモドキアコウ
ビンナガ	ビンナガ
ビードロ	ビードロ
ビーバー	ビーバー
ビーフシチュー	ビーフシチュー
ビール	ビール
ピアノ	ピアノ
ピオーネ	ピオーネ
ピカ	ピカ
ピグミーチンパンジー	ピグミーチンパンジー
ピグミーネズミキツネザル	ピグミーネズミキツネザル
ピグミーマーモセット	ピグミーマーモセット
ピサゴラス	ピサゴラス
ピザ	ピザ
ピスタチオ	ピスタチオ
ピヤノ	ピヤノ
ピュー	ピュー
ピューマ	ピューマ
ピラフ	ピラフ
ピラミッド	ピラミッド
ピン	ピン
ピンク	ピンク
ピンセット	ピンセット
ピーマン	ピーマン
フ	フ
ファイル	ファイル
ファン	ファン
ファンクション	ファンクション
フィギュア	フィギュア
フィナンシェ	フィナンシェ
フィロクラドゥス	フィロクラドゥス
フィンガーライム	フィンガーライム
フウ	フウ
フウセンカズラ	フウセンカズラ
フェイジョア	フェイジョア
フェス	フェス
フェネック	フェネック
フェネックギツネ	フェネックギツネ
フェレット	フェレット
フォー	フォー
フキ	フキ
フクジュソウ	フクジュソウ
フクロアリクイ	フクロアリクイ
フクロウ	フクロウ
フクロネズミ	フクロネズミ
フクロモグラ	フクロモグラ
フグ	フグ
フケ	フケ
フサザクラ	フサザクラ
フサスグリ	フサスグリ
フジ	フジ
フタコブラクダ	フタコブラクダ
フタユビナマケモノ	フタユビナマケモノ
フトモモ	フトモモ
フトモモ科	フトモモカ
フナ	フナ
フフフフ	フフフフ
フヨウ	フヨウ
フライ	フライ
フラッシュ	フラッシュ
フラミンゴ	フラミンゴ
フランクリン	フランクリン
フランス	フランス
フランネル	フランネル
フリー	フリー
フリージア	フリージア
フルーツ	フルーツ
フレンチトースト	フレンチトースト
フレンチドレッシング	フレンチドレッシング
フロック	フロック
フロックコート	フロックコート
フロント	フロント
フン	フン
ブイ	ブイ
ブイヨン	ブイヨン
ブタ	ブタ
ブチハイエナ	ブチハイエナ
ブックカバー	ブックカバー
ブッソウゲ	ブッソウゲ
ブドウ	ブドウ
ブナ	ブナ
ブライトン	ブライトン
ブラクストーン	ブラクストーン
ブラジリアン・ローズウッド	ブラジリアンローズウッド
ブラジル産	ブラジルサン
ブラック	ブラック
ブラックサンダー	ブラックサンダー
ブラックベリー	ブラックベリー
ブラックペッパー	ブラックペッパー
ブランデーケーキ	ブランデーケーキ
ブリ	ブリ
ブリッジ	ブリッジ
ブルグマンシア	ブルグマンシア
ブルヌチェル	ブルヌチェル
ブルーベリー	ブルーベリー
ブログ	ブログ
ブロッコリー	ブロッコリー
ブロッコリースプラウト	ブロッコリースプラウト
ブーゲンビリア	ブーゲンビリア
プッシング	プッシング
プラクテカル	プラクテカル
プラス	プラス
プラタヌス	プラタヌス
プラットフォーム	プラットフォーム
プラットホーム	プラットホーム
プラモデル	プラモデル
プリオシン	プリオシン
プリッツ	プリッツ
プリン	プリン
プリンアラモード	プリンアラモード
プリンタ	プリンタ
プリント	プリント
プルコギ	プルコギ
プルーラブアス	プルーラブアス
プルーン	プルーン
プレコ	プレコ
プレートー	プレートー
プレーリードッグ	プレーリードッグ
プログラミング言語	プログラミングゲンゴ
プロステチュウト	プロステチュウト
プロセス	プロセス
プロバビリティ	プロバビリティ
プロローグ	プロローグ
プロータス	プロータス
ヘクタール	ヘクタール
ヘクトー	ヘクトー
ヘダイ	ヘダイ
ヘッ	ヘッ
ヘノモチン	ヘノモチン
ヘビ	ヘビ
ヘボ	ヘボ
ヘラコウモリ	ヘラコウモリ
ヘラジカ	ヘラジカ
ヘレボラス	ヘレボラス
ヘロドタス	ヘロドタス
ヘンレー	ヘンレー
ヘーゼルナッツ	ヘーゼルナッツ
ベオウルフ	ベオウルフ
ベゴニア	ベゴニア
ベタ	ベタ
ベトナム	ベトナム
ベニザケ	ベニザケ
ベニバナ	ベニバナ
ベビースターラーメン	ベビースターラーメン
ベラ	ベラ
ベランメー	ベランメー
ベリー	ベリー
ベル	ベル
ベルガモット	ベルガモット
ベルサイユ宮殿	ベルサイユキュウデン
ベルーガ	ベルーガ
ベンチ	ベンチ
ベーコン	ベーコン
ベースボール	ベースボール
ベータ	ベータ
ペカン	ペカン
ペスト	ペスト
ペット	ペット
ペテン師	ペテンシ
ペネロピー	ペネロピー
ペペロンチーノ	ペペロンチーノ
ペルシャ	ペルシャ
ペン	ペン
ペンギン	ペンギン
ペンペン草	ペンペングサ
ペンホルダー	ペンホルダー
ペン立て	ペンダテ
ページ	ページ
ペーパー	ペーパー
ペーパーナイフ	ペーパーナイフ
ホウセンカ	ホウセンカ
ホウボウ	ホウボウ
ホオジロザメ	ホオジロザメ
ホオズキ	ホオズキ
ホオノキ	ホオノキ
ホコリ	ホコリ
ホタル	ホタル
ホタルイカ	ホタルイカ
ホッキョクグマ	ホッキョクグマ
ホッケ	ホッケ
ホッチキス	ホッチキス
ホットソース	ホットソース
ホットドッグ	ホットドッグ
ホテイアオイ	ホテイアオイ
ホテイウオ	ホテイウオ
ホテル	ホテル
ホトケノザ	ホトケノザ
ホトトギス	ホトトギス
ホホホ	ホホホ
ホホホホ	ホホホホ
ホヤ	ホヤ
ホリゾンタル	ホリゾンタル
ホルダー	ホルダー
ホルモン	ホルモン
ホワイトカラント	ホワイトカラント
ホワイトペッパー	ホワイトペッパー
ホワイトボード	ホワイトボード
ホンドギツネ	ホンドギツネ
ホンドモモンガ	ホンドモモンガ
ホンヒ	ホンヒ
ホンベラ	ホンベラ
ホーマー	ホーマー
ホームパイ	ホームパイ
ボイ	ボイ
ボイセンベリー	ボイセンベリー
ボウズハゼ	ボウズハゼ
ボケ	ボケ
ボス	ボス
ボタン	ボタン
ボックス	ボックス
ボノボ	ボノボ
ボラ	ボラ
ボランティア	ボランティア
ボルネオオランウータン	ボルネオオランウータン
ボロ	ボロ
ボロニア	ボロニア
ボロネーゼ	ボロネーゼ
ボー	ボー
ボーイ	ボーイ
ボート	ボート
ボード	ボード
ボードゲーム	ボードゲーム
ボール	ボール
ボールド	ボールド
ボールペン	ボールペン
ボーン	ボーン
ポインセチア	ポインセチア
ポウポウ	ポウポウ
ポカーン	ポカーン
ポケット	ポケット
ポストイット	ポストイット
ポッキー	ポッキー
ポッケット	ポッケット
ポッチリ	ポッチリ
ポップコーン	ポップコーン
ポテトサラダ	ポテトサラダ
ポテトチップス	ポテトチップス
ポトフ	ポトフ
ポピー	ポピー
ポプラ	ポプラ
ポポウ	ポポウ
ポポー	ポポー
ポマード	ポマード
ポリス	ポリス
ポン	ポン
ポン酢	ポンズ
ポーポー	ポーポー
マアナゴ	マアナゴ
マイスター	マイスター
マイナス	マイナス
マカロニサラダ	マカロニサラダ
マカロン	マカロン
マキ	マキ
マグネ	マグネ
マグネシヤ	マグネシヤ
マグロ	マグロ
マス	マス
マスカット	マスカット
マスキングテープ	マスキングテープ
マスク	マスク
マスクメロン	マスクメロン
マスノスケ	マスノスケ
マダコ	マダコ
マダム	マダム
マチ	マチ
マッコウクジラ	マッコウクジラ
マッサージ	マッサージ
マッチ箱	マッチバコ
マット	マット
マツ	マツ
マツグミ	マツグミ
マツバボタン	マツバボタン
マツブサ	マツブサ
マツムシソウ	マツムシソウ
マテバシイ	マテバシイ
マトウダイ	マトウダイ
マドレーヌ	マドレーヌ
マドンナ	マドンナ
マナティー	マナティー
マハゼ	マハゼ
マハタ	マハタ
マフィン	マフィン
ママ	ママ
マムシ	マムシ
マメ	マメ
マメガキ	マメガキ
マメ科	マメカ
マユミ	マユミ
マヨネーズ	マヨネーズ
マリヤ	マリヤ
マリーゴールド	マリーゴールド
マルアジ	マルアジ
マルキシスト	マルキシスト
マルキシズム	マルキシズム
マルクス	マルクス
マルクス経済学	マルクスケイザイガク
マルゲリータ	マルゲリータ
マルソ	マルソ
マルバアオダモ	マルバアオダモ
マルバノキ	マルバノキ
マルメロ	マルメロ
マレー	マレー
マレーバク	マレーバク
マン	マン
マングース	マングース
マンゴ	マンゴ
マンゴスチン	マンゴスチン
マンゴー	マンゴー
マンサク	マンサク
マンジュシャゲ	マンジュシャゲ
マンタ	マンタ
マント	マント
マントヒヒ	マントヒヒ
マンドリル	マンドリル
マンホール	マンホール
マンボウ	マンボウ
マーカス	マーカス
マーカー	マーカー
マーガリン	マーガリン
マーガレット	マーガレット
マーブルチョコ	マーブルチョコ
マーモセット	マーモセット
マーモット	マーモット
ミイラ	ミイラ
ミカン	ミカン
ミカン科	ミカンカ
ミジンコ	ミジンコ
ミスミソウ	ミスミソウ
ミズキ	ミズキ
ミズダコ	ミズダコ
ミズナラ	ミズナラ
ミズバショウ	ミズバショウ
ミズメ	ミズメ
ミチリミチリ	ミチリミチリ
ミックス	ミックス
ミツ	ミツ
ミツデカエデ	ミツデカエデ
ミニトマト	ミニトマト
ミネストローネ	ミネストローネ
ミノカサゴ	ミノカサゴ
ミヤギノハギ	ミヤギノハギ
ミヤマガマズミ	ミヤマガマズミ
ミヤマキリシマ	ミヤマキリシマ
ミヤマビャクシン	ミヤマビャクシン
ミュッセ	ミュッセ
ミュージカル	ミュージカル
ミルキー	ミルキー
ミルク	ミルク
ミルフィーユ	ミルフィーユ
ミンククジラ	ミンククジラ
ミント	ミント
ミーアキャット	ミーアキャット
ミートソース	ミートソース
ミートローフ	ミートローフ
ムカムカ	ムカムカ
ムクゲ	ムクゲ
ムクロジ	ムクロジ
ムササビ	ムササビ
ムスカリ	ムスカリ
ムスタッファ	ムスタッファ
ムツ	ムツ
ムツオビアルマジロ	ムツオビアルマジロ
ムベ	ムベ
ムラサキケマン	ムラサキケマン
ムラサキサギゴケ	ムラサキサギゴケ
ムラサキシキブ	ムラサキシキブ
ムラサキツユクサ	ムラサキツユクサ
ムラサキハシドイ	ムラサキハシドイ
ムロアジ	ムロアジ
ムーンライト	ムーンライト
メガネザル	メガネザル
メギ科	メギカ
メグスリノキ	メグスリノキ
メジ	メジ
メジナ	メジナ
メジャー	メジャー
メタセコイア	メタセコイア
メダイ	メダイ
メダカ	メダカ
メチャラクチャラ	メチャラクチャラ
メドラー	メドラー
メヌケ	メヌケ
メバチ	メバチ
メバル	メバル
メモ	メモ
メモ帳	メモチョウ
メリンス	メリンス
メレジス	メレジス
メロン	メロン
メロンパン	メロンパン
メンチ	メンチ
メンチカツ	メンチカツ
メートル	メートル
メートル法	メートルホウ
メープルシロップ	メープルシロップ
モウセンゴケ	モウセンゴケ
モガ	モガ
モクセイ	モクセイ
モクレン	モクレン
モグラ	モグラ
モジリアニ	モジリアニ
モダニティ	モダニティ
モチ	モチ
モチノキ	モチノキ
モッコク	モッコク
モデル	モデル
モナカ	モナカ
モハメッド	モハメッド
モボ	モボ
モミ	モミ
モミジバフウ	モミジバフウ
モモ	モモ
モモタロウ	モモタロウ
モモンガ	モモンガ
モモンガー	モモンガー
モルヒネ	モルヒネ
モルモット	モルモット
モロコ	モロコ
モロヘイヤ	モロヘイヤ
モン	モン
モンキー	モンキー
モンブラン	モンブラン
モーニング	モーニング
ヤ	ヤ
ヤイトハタ	ヤイトハタ
ヤエザクラ	ヤエザクラ
ヤカン	ヤカン
ヤガラ	ヤガラ
ヤギ	ヤギ
ヤクタネゴヨウ	ヤクタネゴヨウ
ヤグルマギク	ヤグルマギク
ヤケクソ	ヤケクソ
ヤシオツツジ	ヤシオツツジ
ヤシャブシ	ヤシャブシ
ヤスリ	ヤスリ
ヤソ	ヤソ
ヤチダモ	ヤチダモ
ヤツデ	ヤツデ
ヤツメウナギ	ヤツメウナギ
ヤドリギ	ヤドリギ
ヤナギ	ヤナギ
ヤナギタンポポ	ヤナギタンポポ
ヤブツバキ	ヤブツバキ
ヤブムラサキ	ヤブムラサキ
ヤマアラシ	ヤマアラシ
ヤマウコギ	ヤマウコギ
ヤマウルシ	ヤマウルシ
ヤマグワ	ヤマグワ
ヤマナラシ	ヤマナラシ
ヤマネコ	ヤマネコ
ヤマブキ	ヤマブキ
ヤマボウシ	ヤマボウシ
ヤマメ	ヤマメ
ヤマモガシ	ヤマモガシ
ヤマモモ	ヤマモモ
ヤマユリ	ヤマユリ
ヤモリ	ヤモリ
ヤリイカ	ヤリイカ
ヤリタナゴ	ヤリタナゴ
ユウガオ	ユウガオ
ユキアネサ	ユキアネサ
ユキウサギ	ユキウサギ
ユキオナゴ	ユキオナゴ
ユキジョロウ	ユキジョロウ
ユキノシタ	ユキノシタ
ユキヒョウ	ユキヒョウ
ユキムスメ	ユキムスメ
ユキヤナギ	ユキヤナギ
ユスラウメ	ユスラウメ
ユリ	ユリ
ユリノ	ユリノ
ユリノキ	ユリノキ
ユーカリ	ユーカリ
ユーゴー	ユーゴー
ユーミアス	ユーミアス
ユーラシアカワウソ	ユーラシアカワウソ
ヨガ	ヨガ
ヨグソミネバリ	ヨグソミネバリ
ヨシ	ヨシ
ヨシノボリ	ヨシノボリ
ヨシ子	ヨシコ
ヨックモック	ヨックモック
ヨルガオ	ヨルガオ
ヨーロッパ	ヨーロッパ
ヨーロッパイチイ	ヨーロッパイチイ
ライオン	ライオン
ライチ	ライチ
ライト	ライト
ライフ	ライフ
ライブ	ライブ
ライプニッツ	ライプニッツ
ライム	ライム
ライラック	ライラック
ラオス	ラオス
ラクウショウ	ラクウショウ
ラクダ	ラクダ
ラケット	ラケット
ラザニア	ラザニア
ラズベリー	ラズベリー
ラッコ	ラッコ
ラッセル	ラッセル
ラッパ	ラッパ
ラバ	ラバ
ラファエル	ラファエル
ラフハエル	ラフハエル
ラベル	ラベル
ラベンダー	ラベンダー
ラマ	ラマ
ラムネ	ラムネ
ラムプシェード	ラムプシェード
ラムボール	ラムボール
ラン	ラン
ランカシャイヤ	ランカシャイヤ
ランブータン	ランブータン
ランプ	ランプ
ラ・フランス	ラフランス
ラーメン	ラーメン
ラー油	ラーユ
リクガメ	リクガメ
リス	リス
リスザル	リスザル
リゾット	リゾット
リチウム	リチウム
リチャード	リチャード
リッツ	リッツ
リトル	リトル
リャマ	リャマ
リュウキュウマツ	リュウキュウマツ
リュウグウノツカイ	リュウグウノツカイ
リュックサック	リュックサック
リョウブ	リョウブ
リラ	リラ
リンク	リンク
リング	リング
リンゴ	リンゴ
リンドウ	リンドウ
リンネル	リンネル
リンボク	リンボク
リー	リー
リーシャス	リーシャス
リーダー	リーダー
リードル	リードル
ルアン	ルアン
ルアンダ	ルアンダ
ルアンパバーン	ルアンパバーン
ルイ14世	ルイジュウヨンセイ
ルカ	ルカ
ルクセンブルク	ルクセンブルク
ルシファー	ルシファー
ルス	ルス
ルソン島	ルソントウ
ルックス	ルックス
ルックバイス	ルックバイス
ルッコラ	ルッコラ
ルドベキア	ルドベキア
ルドルフ	ルドルフ
ルナ	ルナ
ルナアル	ルナアル
ルネ	ルネ
ルネサンス	ルネサンス
ルバイヤット	ルバイヤット
ルパン	ルパン
ルパン三世	シュジンコウノルパンサンセイ
ルビ	ルビ
ルビー	ルビー
ルピナス	ルピナス
ルフィ	ルフィ
ルベーグ積分	ルベーグセキブン
ルポ	ルポ
ルポライター	ルポライター
ルミナリエ	ルミナリエ
ルミネーション	ルミネーション
ルリムスカリ	ルリムスカリ
ルルーシュ	ルルーシュ
ルワンダ	ルワンダ
ルーキー	ルーキー
ルーク	ルーク
ルーシー	ルーシー
ルージュ	ルージュ
ルーズリーフ	ルーズリーフ
ルータ	ルータ
ルーティング	ルーティング
ルート	ルート
ルートディレクトリ	ルートディレクトリ
ルートビア	ルートビア
ルート証明書	ルートショウメイショ
ルーブル	ルーブル
ルーブル美術館	ルーブルビジュツカン
ループ	ループ
ループバックアドレス	ループバックアドレス
ルーベ	ルーベ
ルーペ	ルーペ
ルーマニア	ルーマニア
ルーミン	ルーミン
ルーム	ルーム
ルームシェア	ルームシェア
ルール	ルール
ルーレット	ルーレット
レイシ	レイシ
レコード	レコード
レスター	レスター
レストラン	レストラン
レタス	レタス
レター	レター
レッサーパンダ	レッサーパンダ
レッテル	レッテル
レッド	レッド
レッドカラント	レッドカラント
レバノンスギ	レバノンスギ
レブンウスユキソウ	レブンウスユキソウ
レポート	レポート
レミング	レミング
レモン	レモン
レモンペッパー	レモンペッパー
レモン汁	レモンジル
レンギョウ	レンギョウ
レンゲソウ	レンゲソウ
レンゲツツジ	レンゲツツジ
レンコオト	レンコオト
レンコン	レンコン
レンズ	レンズ
レンブラント	レンブラント
レーズンサンド	レーズンサンド
レール	レール
ロイド	ロイド
ロウヤガキ	ロウヤガキ
ロギン	ロギン
ロコモコ	ロコモコ
ロバ	ロバ
ロマンス	ロマンス
ロンガン	ロンガン
ローガン	ローガン
ロース	ロース
ローストビーフ	ローストビーフ
ローズウッド	ローズウッド
ローズマリー	ローズマリー
ロード	ロード
ロールケーキ	ロールケーキ
ワイス	ワイス
ワイン	ワイン
ワザ	ワザ
ワシ	ワシ
ワシントン条約	ワシントンジョウヤク
ワスレナグサ	ワスレナグサ
ワットマン	ワットマン
ワッフル	ワッフル
ワニ	ワニ
ワニザメ	ワニザメ
ワニス	ワニス
ワハハハハハ	ワハハハハハ
ワラ	ワラ
ワラビー	ワラビー
ワレモコウ	ワレモコウ
ワンワン	ワンワン
ン	ン
ンバ	ンバ
ヵ年	カネン
ヵ月	カゲツ
ヶ所	カショ
ヶ月	カゲツ
ヶ条	カジョウ
ー	ー
一	イチ
一ご	イチゴ
一すじ	ヒトスジ
一だ	イチダ
一つ	ヒトツ
一つ一つ	ヒトツヒトツ
一つ穴	ヒトツアナ
一ぱい	イッパイ
一ノ谷	イチノタニ
一一	ヒトツヒトツ
一丁	イッチョウ
一丁目	イッチョウメ
一七日	ヒトナノカ
一世	イッセイ
一世一代	イッセイチダイ
一両日	イチリョウジツ
一二	カズジ
一二三	ヒフミ
一人	カズト
一人ぼっち	ヒトリボッチ
一人一人	ヒトリヒトリ
一人前	イチニンマエ
一人天下	ヒトリデンカ
一人娘	ヒトリムスメ
一人物	イチジンブツ
一人相撲	ヒトリズモウ
一代	イチダイ
一件	イッケン
一体	イッタイ
一個	イッコ
一円	イチエン
一分	イチブ
一分一厘	イチブイチリン
一切	イッサイ
一切衆生	イッサイシュジョウ
一列	カズナミ
一刻	イッコク
一剣	イッケン
一助	イチジョ
一区切り	ヒトクギリ
一反	イッタン
一口	ヒトクチ
一句	イック
一同	イチドウ
一周	イッシュウ
一味唐辛子	イチミトウガラシ
一味徒党	イチミトトウ
一命	イチメイ
一員	イチイン
一喜一憂	イッキイチユウ
一喝	イッカツ
一坪	イチツボ
一場	イチジョウ
一変	イッペン
一夏	イッカチィ
一夜	イチヤ
一夜さ	ヒトヨサ
一夜作り	イチヤヅクリ
一大	イチダイ
一大事	イチダイジ
一夫多妻	イップタサイ
一存	イチゾン
一定	イッテイ
一定の場所	イッテイノバショ
一室	イッシツ
一家	イッカ
一家相伝	イッカソウデン
一寸	イッスン
一寸法師	イッスンボウシ
一対	イッツイ
一巡	イチジュン
一巻	イッカン
一帯	イッタイ
一幕	ヒトマク
一年	カズトシ
一年生	イチネンセイ
一座	イチザ
一廉	ヒトカド
一心不乱	イッシンフラン
一念	イチネン
一念万年	イチネンバンネン
一息	ヒトイキ
一意	イチイ
一戸	イチノヘ
一所	イッショ
一所不住	イッショフジュウ
一手	イッテ
一打	イチダ
一挙両得	イッキョリョウトク
一挙手一投足	イッキョシュイットウソク
一掬の涙	イッキクノナミダ
一撃	イチゲキ
一文	イチブン
一方	イッポウ
一族	イチゾク
一日	ヒトイチ
一昨々年	サキオトトシ
一昨年	イッサクネン
一昨日	オトトイ
一時	イチジ
一晩	ヒトバン
一月	イチガツ
一朝	イッチョウ
一朝一夕	イッチョウイッセキ
一本	イッポン
一本勝負	イッポンショウブ
一束	イッソク
一条	イチジョウ
一杯	イッパイ
一杯のビール	イッパイノビール
一枚岩	イチマイイワ
一枚看板	イチマイカンバン
一棟	イチムネ
一概	イチガイ
一様	イチヨウ
一樹	イチジュ
一歩	ハジメ
一段	イチダン
一段落	イチダンラク
一毫	イチゴウ
一気	イッキ
一気呵成	イッキカセイ
一決	イッケツ
一流	イチリュウ
一滴	イッテキ
一点	イテン
一片	イッペン
一物	イチモツ
一瓢	イッピョウ
一生	イッショウ
一生けん命	イッショウケンメイ
一生懸命	イッショウケンメイ
一町	イッチョウ
一番	イチバン
一番槍	イチバンヤリ
一疋	イッピキ
一目	イチモク
一目散	イチモクサン
一直線	イッチョクセン
一眼	イチガン
一睡	イッスイ
一瞥	イチベツ
一瞬	イッシュン
一石	ヒトツイシ
一礼	イチレイ
一秒	イチビョウ
一種	イッシュ
一種異様	イッシュイヨウ
一穂	イチホ
一端	イッタン
一竿風月	イッカンノフウゲツ
一等	イットウ
一筋	ヒトスジ
一策	イッサク
一節	イッセツ
一級	イッキュウ
一結杳然	イッケツヨウゼン
一緒	イッショ
一緒に	イッショニ
一線	イッセン
一縷	イチル
一群	イチグン
一羽	イチワ
一致	イッチ
一般	イッパン
一般的	イッパンテキ
一色	イッショク
一葉	イチヨウ
一行	イッコウ
一見	イッケン
一覧	イチラン
一言	ヒトコト
一言半句	イチゴンハンク
一語	イチゴ
一貫	イッカン
一足	イッソク
一足飛	イッソクトビ
一足飛び	イッソクトビ
一路	イチロ
一躍	イチヤク
一身	イッシン
一身上	イッシンジョウ
一身上の都合	イッシンジョウノツゴウ
一軒	イッケン
一軒家	イッケンヤ
一軒屋	イッケンヤ
一転	イッテン
一輪の花	イチリンノハナ
一辺	イッペン
一通	イッツウ
一通り	ヒトトオリ
一週	イッシュウ
一週間	イッシュウカン
一進一退	イッシンイッタイ
一遍	イッペン
一過	イッカ
一道	イチドウ
一郡	イチグン
一部	イチブ
一部分	イチブブン
一部始終	イチブシジュウ
一重	ヒトエ
一銭	イッセン
一銭五厘	イッセンゴリン
一間	イッケン
一隅	イチグウ
一隊	イッタイ
一面	イチメン
一面識	イチメンシキ
一顰一笑	イッピンイッショウ
一風	イップウ
一飯君恩	イッパンクンオン
一騎当千	イッキトウセン
丁	チョウ
丁寧	テイネイ
丁度	チョウド
丁稚	デッチ
七	ナナ
七つ	ナナツ
七つか	ナナツカ
七分	シチブ
七味	シチミ
七味唐辛子	シチミトウガラシ
七夕	タナバタ
七擒七縦	シチキンシチショウ
七日	ナヌカ
七星	ナナエ
七時	シチジ
七月	シチガツ
七転び八起き	ナナコロビヤオキ
七輪	シチリン
万	バン
万が一	マンガイチ
万万歳	バンバンザイ
万丈	バンジョウ
万世一系	バンセイイッケイ
万事	バンジ
万人	バンニン
万全	バンゼン
万古不磨	バンコフマ
万国	バンコク
万年	カズトシ
万年筆	マンネンヒツ
万歳	バンザイ
万物	バンブツ
万葉調	マンヨウチョウ
万言	マンゲン
万里	バンリ
丈	タケ
丈夫	ジョウブ
三	サン
三々九度	サンサンクド
三ぜん	サンゼン
三つ	ミッツ
三つや	ミツヤ
三つ子	ミツゴ
三つ目	ミツメ
三つ葉	ミツバ
三丁目	サンチョウメ
三七日	サンシチニチ
三世相	サンゼソウ
三代	ミジロ
三信	サンシン
三個	サンガ
三分	ミブン
三分一	サンブイチ
三助	サンスケ
三区	サンク
三十一文字	ミソヒトモジ
三十三	サンジュウサン
三十三間堂	サンジュウサンゲンドウ
三十五	サンジュウゴ
三十四	ミトシ
三口	ミツクチ
三名	サンミョウ
三味線	シャミセン
三品	ミシナ
三四	サンシ
三坪	ミツボ
三大	ミオウ
三太郎	サンタロウ
三女	サンジョ
三女子	サンヨシ
三字	サンジ
三寸	サンズン
三尺	サンジャク
三平	サンペイ
三年	ミトシ
三年味噌	サンネンミソ
三度	サンド
三方	ミカタ
三日	ミッカ
三日月	ミカヅキ
三時	サンジ
三更	サンコウ
三月	サンガツ
三本	ミツモト
三杯	サンバイ
三枚	サンマイ
三枚目	サンマイメ
三次	ミツギ
三歩	サンブ
三歳	ミトセ
三毛	ミケ
三河万歳	ミカワマンザイ
三流	サンリュウ
三町	サンチョウ
三番	サンバン
三盆	サンボン
三羽	サンパ
三股	ミマタ
三色団子	サンショクダンゴ
三葉	ミツバ
三角	サンカク
三角定規	サンカクジョウギ
三角形	サンカッケイ
三角点	サンカクテン
三足	ミアシ
三軒	サンゲン
三間	サンゲン
三階	サンカイ
三面	サンメン
上	ウエ
上がったり	アガッタリ
上がり	アガリ
上げ	アゲ
上せん	ジョウセン
上の	ウエノ
上の空	ウワノソラ
上らん	ジョウラン
上り	ノボリ
上り口	アガリグチ
上下	ジョウカ
上乗	ジョウジョウ
上京	ジョウキョウ
上今	カミイマ
上代	ジョウダイ
上代特殊仮名遣	ジョウダイトクシュカナヅカイ
上使	ジョウシ
上出来	ジョウデキ
上分別	ジョウフンベツ
上前	ウワマエ
上半身	ジョウハンシン
上司	ジョウシ
上品	ジョウヒン
上奥	ウエオク
上家	ウワヤ
上層	ジョウソウ
上山	ウエヤマ
上席	ジョウセキ
上座	カミザ
上手	ジョウズ
上手者	ジョウズモノ
上旬	ジョウジュン
上書	ジョウショ
上根岸	カミネギシ
上機嫌	ジョウキゲン
上段	ジョウダン
上流	ジョウリュウ
上田	ウエダ
上田敏	ウエダビン
上白	ジョウハク
上皮	ジョウヒ
上着	ウワギ
上等	ジョウトウ
上策	ジョウサク
上級生	ジョウキュウセイ
上総	カツサ
上衣	ウワギ
上記	ジョウキ
上達	ジョウタツ
上達部	カンダチメ
上部	ジョウブ
上野	ウエノ
上野公園	ウエノコウエン
上野桜木	ウエノサクラギ
上陸	ジョウリク
下	シタ
下げ	サゲ
下り	クダリ
下世話	ゲセワ
下人	ゲニン
下付き	シタツキ
下剤	ゲザイ
下劣	ゲレツ
下向	ゲコウ
下品	ゲヒン
下士	カシ
下士官	カシカン
下女	ゲジョ
下婢	カヒ
下宿	ゲシュク
下宿人	ゲシュクニン
下層	カソウ
下心	シタゴコロ
下手	ヘタ
下手くそ	ヘタクソ
下敷き	シタジキ
下旬	ゲジュン
下流	カリュウ
下火	シタビ
下男	ゲナン
下町	シタマチ
下界	ゲカイ
下痢	ゲリ
下着	シタギ
下等	カトウ
下落	ゲラク
下記	カキ
下読	シタヨミ
下谷	シモタニ
下部	カブ
下隅	シタスミ
下駄	ゲタ
下駄箱	ゲタバコ
不たしか	フタシカ
不人情	フニンジョウ
不仕合	フシアワセ
不仕合せ	フシアワセ
不似合	フニアイ
不体裁	フテイサイ
不作	フサク
不便	フベン
不信	フシン
不信任	フシンニン
不備	フビ
不充分	フジュウブン
不公平	フコウヘイ
不具	フグ
不利	フリ
不利益	フリエキ
不動智神妙録	フドウチシンミョウロク
不十分	フジュウブン
不即不離	フソクフリ
不可思議	フカシギ
不可測	フカソク
不可能	フカノウ
不可解	フカカイ
不合理	フゴウリ
不吉	フキツ
不同意	フドウイ
不名誉	フメイヨ
不和	フワ
不器用	ブキヨウ
不器量	ブキリョウ
不埒	フラチ
不始末	フシマツ
不孝	フコウ
不安	フアン
不完全	フカンゼン
不定	フテイ
不審	フシン
不導体	フドウタイ
不平	フヘイ
不幸	フコウ
不当	フトウ
不得要領	フトクヨウリョウ
不徳	フトク
不徳義	フトクギ
不快	フカイ
不思議	フシギ
不恰好	ブカッコウ
不愉快	フユカイ
不愉快です	フユカイデス
不意	フイ
不慮	フリョ
不憫	フビン
不手際	フテギワ
不承	フショウ
不承知	フショウチ
不振	フシン
不敬	フケイ
不断	フダン
不明	フメイ
不明瞭	フメイリョウ
不時	フジ
不機嫌	フキゲン
不死	フシ
不気味	ブキミ
不浄	フジョウ
不満	フマン
不満足	フマンゾク
不滅	フメツ
不潔	フケツ
不用	フヨウ
不用心	フヨウジン
不用意	フヨウイ
不相応	フソウオウ
不眠	フミン
不穏	フオン
不穏当	フオントウ
不肖	フショウ
不自然	フシゼン
不自由	フジユウ
不良	フリョウ
不行届	フユキトドキ
不要	フヨウ
不見識	フケンシキ
不覚	フカク
不言	フゲン
不評判	フヒョウバン
不調	フチョウ
不調和	フチョウワ
不調法	ブチョウホウ
不貞	フテイ
不賛成	フサンセイ
不足	フソク
不透明	フトウメイ
不運	フウン
不道徳	フドウトク
不適	フテキ
不都合	フツゴウ
不面目	フメンボク
不順	フジュン
不馴れ	フナレ
与太者	ヨタモノ
与太郎	ヨタロウ
丑	ウシ
世	ヨ
世のなか	ヨノナカ
世の中	ヨノナカ
世の常	ヨノツネ
世上	セジョウ
世人	セジン
世尊	セソン
世帯	セタイ
世態人情	セタイニンジョウ
世故	セコ
世渡り	ヨワタリ
世界	セカイ
世界中	セカイジュウ
世界各地	セカイカクチ
世界的	セカイテキ
世紀	セイキ
世話	セワ
世話物	セワモノ
世辞	セジ
世間	セケン
世間並	セケンナミ
世間体	セケンテイ
世間話	セケンバナシ
丘	オカ
丞	ススム
両	リョウ
両三日	リョウサンニチ
両人	リョウニン
両側	リョウガワ
両君	リョウクン
両国	リョウコク
両天秤	リョウテンビン
両家	リョウケ
両度	リョウド
両手	リョウテ
両方	リョウホウ
両替町	リョウガエチョウ
両生類	リョウセイルイ
両目	リョウメ
両立	リョウリツ
両端	リョウタン
両者	リョウシャ
両親	リョウシン
両足	リョウアシ
両隣	リョウドナリ
両面	リョウメン
並	ナミ
並び	ナラビ
並べ方	ナラベカタ
中	ナカ
中ごろ	ナカゴロ
中て	ナカテ
中の間	ナカノマ
中位	チュウイ
中味	ナカミ
中国	チュウゴク
中天	チュウテン
中央	チュウオウ
中央地区	チュウオウチク
中学	チュウガク
中学一年生	チュウガクイチネンセイ
中学教師	チュウガクキョウシ
中学時代	チュウガクジダイ
中学校	チュウガッコウ
中学生	チュウガクセイ
中将	チュウジョウ
中層	チュウソウ
中峯	ナカミネ
中年	チュウネン
中庸	チュウヨウ
中形	チュウガタ
中心	チュウシン
中性名詞	チュウセイメイシ
中村	ナカムラ
中止	チュウシ
中段	チュウダン
中毒	チュウドク
中濃ソース	チュウノウソース
中納言	チュウナゴン
中絶	チュウゼツ
中腹	チュウフク
中臣	ナカトミ
中華だし	チュウカダシ
中華丼	チュウカドン
中途	チュウト
中間	チュウカン
中頃	ナカゴロ
中風	チュウブ
串団子	クシダンゴ
丸	マル
丸の内	マルノウチ
丸み	マルミ
丸善	マルゼン
丸坊主	マルボウズ
丸太	マルタ
丸木	マルキ
丸薬	ガンヤク
丸裸	マルハダカ
丹	ニ
丹塗	ニヌリ
丹後	タンゴ
丹念	タンネン
丹波	タンバ
丹精	タンセイ
主	アルジ
主人	シュジン
主人公	シュジンコウ
主任	シュニン
主客	シュキャク
主宰	シュサイ
主張	シュチョウ
主従	シュウジュウ
主意	シュイ
主旨	シュシ
主治医	シュジイ
主筆	シュヒツ
主義	シュギ
主要	シュヨウ
主観	シュカン
主題	シュダイ
主食	シュショク
丼	ドンブリ
乃木	ノギ
久々	ヒサビサ
久しぶり	ヒサシブリ
久し振り	ヒサシブリ
久留米がすり	クルメガスリ
久遠	クオン
之	コレ
乍	ナガラ
乗り	ノリ
乗り手	ノリテ
乗り気	ノリキ
乗客	ジョウキャク
乗気	ノリキ
乙	オツ
乙姫	オトヒメ
九	キュウ
九州	キュウシュウ
九州地方	キュウシュウチホウ
九拝	キュウハイ
九時	クジ
九月	クガツ
九番	クバン
九郎	クロウ
乞食	コジキ
也	ナリ
乱れ	ミダレ
乱入	ランニュウ
乱射	ランシャ
乱暴	ランボウ
乱暴狼藉	ランボウロウゼキ
乱暴者	アバレモノ
乱杭	ラングイ
乱雑	ランザツ
乱麻	ランマ
乳	チチ
乳呑	チチノミ
乳母	オンバ
乾	イヌイ
乾坤	ケンコン
乾杯	カンパイ
乾燥	カンソウ
亀	カメ
亀の甲	カメノコウ
亀屋	カメヤ
了	リョウ
了簡	リョウケン
了見	リョウケン
了解	リョウカイ
予備	ヨビ
予報	ヨホウ
予定	ヨテイ
予定通り	ヨテイドオリ
予審	ヨシン
予想	ヨソウ
予感	ヨカン
予期	ヨキ
予知	ヨチ
予算	ヨサン
予約	ヨヤク
予覚	ヨカク
予言	ヨゲン
予防線	ヨボウセン
争い	アラソイ
争論	ソウロン
事	コト
事だい	ジダイ
事もなげ	コトモナゲ
事件	ジケン
事務	ジム
事務員	ジムイン
事務所	ジムショ
事実	ジジツ
事情	ジジョウ
事態	ジタイ
事故	ジコ
事柄	コトガラ
事業	ジギョウ
事業家	ジギョウカ
事物	ジブツ
事理	ジリ
事蹟	ジセキ
事項	ジコウ
二	ニ
二つ	フタツ
二の句	ニノク
二の腕	ニノウデ
二丁目	ニチョウメ
二三	フミ
二世	ニセイ
二九	フタク
二人	フタリ
二人の女	フタリノオンナ
二八	ニッパチ
二六時中	ニロクジチュウ
二割	フタツワリ
二十一	ニソイチ
二十三	ニジュウサン
二十世紀	ニジッセイキ
二十二	ジソジ
二十八	ツチヤ
二十四	ニジュウヨン
二十歳	ハタチ
二叉	フタマタ
二口	フタクチ
二坪	フタツボ
二字	ニジ
二尾	ニノオ
二年生	ニネンセイ
二戸	ニノヘ
二日	ニノ
二時	ニジ
二月	ニガツ
二本	ニモト
二本足	ニホンアシ
二束三文	ニソクサンモン
二枚重ね	ニマイガサネ
二男	ジナン
二絃琴	ニゲンキン
二者選一	ニシャセンイツ
二言	ニゴン
二通	ニツウ
二里	ニリ
二限	ニゲン
二階	ニカイ
二階建て	ニカイダテ
云	ウン
云々	ウンヌン
互	タガイ
互い違い	タガイチガイ
五	ゴ
五つ	イツツ
五体	ゴタイ
五六	フノボリ
五円札	ゴエンサツ
五分	ゴブ
五十	イ
五十一	イソイチ
五十三	ゴジュウサン
五十二	イソジ
五十五	ゴジュウゴ
五十人	ゴジュウニン
五十六	イソロク
五徳	ゴトク
五感	ゴカン
五拾	ゴジッ
五日	イツカ
五時	ゴジ
五月	ゴガツ
五本	ゴホン
五歩	ゴホ
五行	ゴギョウ
五里霧中	ゴリムチュウ
五重の塔	ゴジュウノトウ
井	イ
井戸	イド
井戸端	イドバタ
些少	サショウ
些細な	ササイナ
亜	ア
亜流	アリュウ
亡国	ボウコク
亡者	モウジャ
亡魂	ボウコン
交	ヨシミ
交互	コウゴ
交代	コウタイ
交叉	コウサ
交友	コウユウ
交戦	コウセン
交換	コウカン
交替	コウタイ
交渉	コウショウ
交番	コウバン
交通	コウツウ
交際	コウサイ
交響楽	コウキョウガク
享	トオル
享受	キョウジュ
京	キョウ
京橋	キョウバシ
京焼	キョウヤキ
京都	キョウト
亭	チン
亭主	テイシュ
人	ヒト
人々	ヒトビト
人さし指	ヒトサシユビ
人たち	ヒトタチ
人を見たら泥棒と思え	ヒトヲミタラドロボウトオモエ
人一倍	ヒトイチバイ
人世	ジンセイ
人並	ヒトナミ
人中	ヒトナカ
人体	ジンタイ
人出	ヒトデ
人前	ヒトマエ
人力	ジンリキ
人力車	ジンリキシャ
人参	ニンジン
人口	ジンコウ
人声	ヒトゴエ
人妻	ヒトヅマ
人家	ジンカ
人山	ヒトヤマ
人工林	ジンコウリン
人工的	ジンコウテキ
人形	ニンギョウ
人影	ヒトカゲ
人情	ニンジョウ
人手	ヒトデ
人指しゆび	ヒトサシユビ
人指し指	ヒトサシユビ
人数	ニンズウ
人文	ジンブン
人望	ジンボウ
人柄	ヒトガラ
人格	ジンカク
人様	ヒトサマ
人殺し	ヒトゴロシ
人民	ジンミン
人気	ニンキ
人気者	ニンキモノ
人為的	ジンイテキ
人物	ジンブツ
人生	ジンセイ
人生の意義	ジンセイノイギ
人生の目的	ジンセイノモクテキ
人生観	ジンセイカン
人的	ジンテキ
人目	ヒトメ
人相	ニンソウ
人真似	ヒトマネ
人種	ジンシュ
人聞き	ヒトギキ
人質	ヒトジチ
人足	ニンソク
人通り	ヒトドオリ
人道	ジンドウ
人達	ヒトタチ
人違い	ヒトチガイ
人間	ニンゲン
人間だもの	ニンゲンダモノ
人間について	ニンゲンニツイテ
人間の声	ニンゲンノコエ
人間の顔	ニンゲンノカオ
人間並	ニンゲンナミ
人間失格	ニンゲンシッカク
人間性	ニンゲンセイ
人間界	ニンゲンカイ
人間社会	ニンゲンシャカイ
人類	ジンルイ
人馬	ジンバ
人魚	ニンギョ
什麼	インモ
仁	ヒトシ
仁王	ニオウ
仇	キュウ
今	イマ
今しがた	イマシガタ
今し方	イマシガタ
今すぐ	イマスグ
今一	イマイチ
今世紀	コンセイキ
今代	イマダイ
今回	コンカイ
今夜	コンヤ
今奥	イマオク
今川焼き	イマガワヤキ
今年	コトシ
今度	コンド
今後	コンゴ
今戸焼	イマドヤキ
今日	キョウ
今日の天気	キョウノテンキ
今日の詩	キョウノウタ
今日様	コンニチサマ
今昔	コンジャク
今昔物語集	コンジャクモノガタリシュウ
今時	イマドキ
今時分	イマジブン
今晩	コンバン
今更	イマサラ
今月	コンゲツ
今朝	ケサ
今来	コンライ
今泣いた烏がもう笑った	イマナイタカラスガモウワラッタ
今般	コンパン
今鏡	イマカガミ
今頃	イマゴロ
介	カイ
仏	フツ
仏作って魂入れず	ホトケツクッテタマシイイレズ
仏像	ブツゾウ
仏具	ブツグ
仏国	ブッコク
仏壇	ブツダン
仏家	ブッケ
仏師	ブッシ
仏教	ブッキョウ
仏生	ブッショウ
仏蘭西	フランス
仏語	フツゴ
仏陀	ブツダ
仏頂面	ブッチョウヅラ
仔細	シサイ
仕事	シゴト
仕付	シツケ
仕儀	シギ
仕切	シキリ
仕切り	シキリ
仕合せ	シアワセ
仕度	シタク
仕打	シウチ
仕掛	シカケ
仕掛け	シカケ
仕方	シカタ
仕方がない	シカタガナイ
仕方なし	シカタナシ
仕来り	シキタリ
仕様	シヨウ
仕立	シタテ
仕立屋	シタテヤ
仕置	シオキ
仕舞	シマイ
仕草	シグサ
他	タ
他人	タニン
他人の家	タニンノイエ
他国	タコク
他家	タケ
他日	タジツ
他殺	タサツ
他流試合	タリュウジアイ
他県	タケン
他言	タゴン
他郷	タキョウ
付	ツケ
付き	ツキ
付く	ツケク
付け	ツケ
付け文	ツケブミ
付属	フゾク
付箋	フセン
仙	セン
仙人	センニン
仙石	センゴク
仙遊	センユウ
仙骨	センコツ
代	ダイ
代々	ダイダイ
代だ	ダイダ
代り	カワリ
代わり	カワリ
代価	ダイカ
代官	ダイカン
代数	ダイスウ
代物	シロモノ
代理	ダイリ
代理人	ダイリニン
代用	ダイヨウ
代目	ダイメ
代筆	ダイヒツ
代表	ダイヒョウ
代表者	ダイヒョウシャ
代言	ダイゲン
代議	ダイギ
令夫人	レイフジン
令嬢	レイジョウ
以上	イジョウ
以下	イカ
以下略	イカリャク
以内	イナイ
以前	イゼン
以外	イガイ
以後	イゴ
以心伝心	イシンデンシン
以来	イライ
以降	イコウ
仮り	カリ
仮名	カメイ
仮定	カテイ
仮寝	カリネ
仮死	カシ
仮病	ケビョウ
仮装	カソウ
仮説	カセツ
仮面	カメン
仰せ	オオセ
仰向	アオムケ
仰向け	アオムケ
仰天	ギョウテン
仰山	ギョウサン
仲	ナカ
仲人	ナコウド
仲働き	ナカバタラキ
仲好	ナカヨシ
仲居	ナカイ
仲店	ナカミセ
仲直り	ナカナオリ
仲良し	ナカヨシ
仲見世	ナカミセ
仲間	ナカマ
仲間入り	ナカマイリ
仲間外れ	ナカマハズレ
件	ケン
任	ニン
任地	ニンチ
任意	ニンイ
任期	ニンキ
企て	クワダテ
伊万里	イマリ
伊予絣	イヨカスリ
伊勢	イセ
伊藤	イトウ
伊藤博文	イトウヒロブミ
伍	ゴ
伎倆	ギリョウ
伏	フク
伏せ	フセ
休	キュウ
休み	ヤスミ
休学	キュウガク
休心	キュウシン
休息	キュウソク
休憩	キュウケイ
休暇	キュウカ
休養	キュウヨウ
会	カイ
会い	カイイ
会いたかった	アイタカッタ
会合	カイゴウ
会場	カイジョウ
会得	エトク
会津	アイヅ
会津っぽ	アイヅッポ
会社	カイシャ
会見	カイケン
会計	カイケイ
会話	カイワ
会談	カイダン
会議	カイギ
会議室	カイギシツ
会釈	エシャク
伝	ツテ
伝い	ツタイ
伝兵衛	デンベエ
伝承	デンショウ
伝授	デンジュ
伝来	デンライ
伝染	デンセン
伝習	デンシュウ
伝聞	デンブン
伝言	デンゴン
伝説	デンセツ
伝通院	デンヅウイン
伯	ハク
伯父	オジ
伯父さん	オジサン
伴	トモ
伴侶	ハンリョ
伴奏	バンソウ
伺い	ウカガイ
似合	ニアイ
似合い	ニアイ
似顔	ニガオ
伽藍	ガラン
佇立	チョリツ
位	クライ
位地	イチ
位牌	イハイ
位置	イチ
低い	ヒクイ
低徊	テイカイ
低木	テイボク
低能	テイノウ
低頭	テイトウ
住	ジュウ
住い	スマイ
住人	ジュウニン
住吉	スミヨシ
住宅	ジュウタク
住家	スミヤ
住居	ジュウキョ
住所	ジュウショ
住持	ジュウジ
住民	ジュウミン
住田	スミタ
佐広	サヒロ
佐渡島	サドシマ
佐渡金山	サドキンザン
佐藤錦	サトウニシキ
体	カラダ
体たらく	テイタラク
体どう	タイドウ
体内	タイナイ
体力	タイリョク
体当たり	タイアタリ
体操	タイソウ
体格	タイカク
体系	タイケイ
体育	タイイク
体裁	テイサイ
体質	タイシツ
体重	タイジュウ
体面	タイメン
何	ナニ
何かしら	ナニカシラ
何くれ	ナニクレ
何とか	ナントカ
何の気なしに	ナンノケナシニ
何もの	ナニモノ
何ら	ナンラ
何事	ナニゴト
何人	ナニビト
何処	ドコ
何分	ナニブン
何度	ナンド
何度でも	ナンドデモ
何時	イツ
何本	ナニモト
何等	ナンラ
何者	ナニモノ
余	ヨ
余り	アマリ
余事	ヨジ
余分	ヨブン
余力	ヨリョク
余呉	ヨゴ
余地	ヨチ
余念	ヨネン
余所	ヨソ
余所ゆき	ヨソユキ
余所余所しい	ヨソヨソシイ
余所目	ヨソメ
余波	ヨハ
余興	ヨキョウ
余裕	ヨユウ
余計	ヨケイ
余計なお世話	ヨケイナオセワ
作	サク
作り	ツクリ
作りごと	ツクリゴト
作中	サクチュウ
作品	サクヒン
作家	サッカ
作成	サクセイ
作戦	サクセン
作法	サホウ
作用	サヨウ
作者	サクシャ
佳人	カジン
佳境	カキョウ
併発	ヘイハツ
併行	ヘイコウ
使	シ
使い	ツカイ
使い方	ツカイカタ
使い道	ツカイミチ
使命	シメイ
使嗾	シソウ
使役	シエキ
使用	シヨウ
使用人	シヨウニン
使用量	シヨウリョウ
使者	シシャ
例	レイ
例刻	レイコク
例外	レイガイ
例年	レイネン
例月	レイゲツ
侍	サムライ
侍女	ジジョ
侍従	ジジュウ
侘び	ワビ
供	キョウ
供え	ソナエ
供給	キョウキュウ
依怙	エゴ
依頼	イライ
価	アタイ
価値	カチ
価格	カカク
価額	カガク
侮蔑	ブベツ
侮辱	ブジョク
侵入	シンニュウ
侵蝕	シンショク
便	ビン
便り	タヨリ
便利	ベンリ
便宜	ベンギ
便所	ベンジョ
便秘	ベンピ
便箋	ビンセン
俄	ニワカ
俎	マナイタ
俗	ゾク
俗事	ゾクジ
俗人	ゾクジン
俗気	ゾクキ
俗物	ゾクブツ
俗称	ゾクショウ
俗耳	ゾクジ
俗語	ゾクゴ
俗諺	ゾクゲン
俗謡	ゾクヨウ
俗骨	ゾッコツ
俚耳	リジ
保た	ホタ
保全状況	ホゼンジョウキョウ
保存	ホゾン
保存会	ホゾンカイ
保持	ホジ
保田	ヤスダ
保管	ホカン
保証	ホショウ
保証人	ホショウニン
保護	ホゴ
保護室	ホゴシツ
保護者	ホゴシャ
保険	ホケン
保険会社	ホケンカイシャ
信	シン
信仰	シンコウ
信号	シンゴウ
信奉	シンポウ
信女	シンニョ
信念	シンネン
信愛	シンアイ
信条	シンジョウ
信用	シンヨウ
信者	シンジャ
信頼	シンライ
信頼性	シンライセイ
修	オサム
修了	シュウリョウ
修学	シュウガク
修学旅行	シュウガクリョコウ
修得	シュウトク
修業	シュウギョウ
修正	シュウセイ
修正液	シュウセイエキ
修理	シュウリ
修繕	シュウゼン
修行	シュギョウ
修身	シュウシン
修養	シュウヨウ
俳人	ハイジン
俳優	ハイユウ
俳句	ハイク
俳味	ハイミ
俳諧	ハイカイ
俵	タワラ
俸給	ホウキュウ
俺	オレ
倅	セガレ
倉	クラ
倉吉	クラヨシ
倉吉市	クラヨシシ
倉皇	ソウコウ
個	コ
個々	ココ
個々別々	ココベツベツ
個中	コチュウ
個人	コジン
個人主義	コジンシュギ
個性	コセイ
個所	カショ
個月	カゲツ
倍	バイ
候	コウ
候補者	コウホシャ
借り	カリ
借りて	カリテ
借家	シャクヤ
借金	シャッキン
値段	ネダン
倦怠	ケンタイ
倫理	リンリ
倫理的	リンリテキ
倹約	ケンヤク
偉人	イジン
偉大	イダイ
偉観	イカン
偏屈	ヘンクツ
偏狭	ヘンキョウ
偕老同穴	カイロウドウケツ
停車	テイシャ
停車場	テイシャジョウ
停電	テイデン
健	ケン
健児	ケンジ
健全	ケンゼン
健吉	ケンキチ
健啖	ケンタン
健在	ケンザイ
健康	ケンコウ
健気	ケナゲ
側	ガワ
側面	ソクメン
偵察	テイサツ
偶像	グウゾウ
偶然	グウゼン
偽	ニセ
偽り	イツワリ
偽善	ギゼン
偽物	ニセモノ
偽筆	ギヒツ
傍	ハタ
傍ら	カタワラ
傍点	ボウテン
傍聴	ボウチョウ
傍若無人	ボウジャクブジン
傑作	ケッサク
傑出	ケッシュツ
傘	カサ
催し	モヨオシ
催促	サイソク
催眠	サイミン
催眠術	サイミンジュツ
傲慢	ゴウマン
傲然	ゴウゼン
傷	キズ
傷み	イタミ
傷口	キズグチ
傷寒論	ショウカンロン
傾向	ケイコウ
傾城	ケイセイ
傾斜	ケイシャ
傾聴	ケイチョウ
僅か	ワズカ
僅少	キンショウ
働	ハタラキ
働き	ハタラキ
働き手	ハタラキテ
像	ゾウ
僕	ボク
僕たち	ボクタチ
僕といっしょ	ボクトイッショ
僕は君	ボクハキミ
僕ら	ボクラ
僥倖	ギョウコウ
僧	ソウ
僧侶	ソウリョ
僧堂	ソウドウ
僭上	センジョウ
僻遠	ヘキエン
儀	ギ
儀式	ギシキ
億	オク
儒家	ジュカ
儒者	ジュシャ
儘	ママ
優しい言葉	ヤサシイコトバ
優勢	ユウセイ
優柔	ユウジュウ
優美	ユウビ
儲け	モウケ
元	モト
元々	モトモト
元信	モトノブ
元君	ゲンクン
元日	ガンジツ
元朝	ガンチョウ
元来	ガンライ
元気	ゲンキ
元気です	ゲンキデス
元気を出して	ゲンキヲダシテ
元祖	ガンソ
元禄	ゲンロク
兄	アニ
兄さん	ニイサン
兄たち	アニタチ
兄と妹	アニトイモウト
兄妹	キョウダイ
兄弟	キョウダイ
兄弟分	キョウダイブン
充分	ジュウブン
充実	ジュウジツ
充満	ジュウマン
充血	ジュウケツ
兇漢	キョウカン
先	サキ
先だって	センダッテ
先ほど	サキホド
先例	センレイ
先刻	センコク
先君	センクン
先夜	センヤ
先天的	センテンテキ
先方	センポウ
先日	センジツ
先月	センゲツ
先生	センセイ
先祖	センゾ
先輩	センパイ
先途	センド
先達て	センダッテ
先鋒	センポウ
光	ヒカリ
光か	ヒカリカ
光彩	コウサイ
光明	コウミョウ
光景	コウケイ
光来	コウライ
光栄	コウエイ
光沢	コウタク
光線	コウセン
光輝	コウキ
克己	コッキ
克復	コクフク
免	メン
免状	メンジョウ
免職	メンショク
兎	ウサギ
児	コ
党	トウ
党勢	トウセイ
党員	トウイン
兜	カブト
入	イリ
入り	ハイリ
入れ	イレ
入ろう	ニュウロウ
入会	ニュウカイ
入力	ニュウリョク
入口	イリグチ
入国	ニュウコク
入学	ニュウガク
入来	イリキ
入水	ジュスイ
入浴	ニュウヨク
入湯	ニュウトウ
入用	イリヨウ
入神	ニュウシン
入籍	ニュウセキ
入院	ニュウイン
全く	ゼンク
全て	スベテ
全体	ゼンタイ
全力	ゼンリョク
全国	ゼンコク
全市	ゼンシ
全快	ゼンカイ
全智	ゼンチ
全書	ゼンショ
全校	ゼンコウ
全権	ゼンケン
全欧	ゼンオウ
全滅	ゼンメツ
全盛	ゼンセイ
全知全能	ゼンチゼンノウ
全能	ゼンノウ
全身	ゼンシン
全速力	ゼンソクリョク
全部	ゼンブ
全集	ゼンシュウ
全面	ゼンメン
八	ハチ
八つ	ヤッツ
八つ橋	ヤツハシ
八つ裂き	ヤツザキ
八丁	ハッチョウ
八万	ハチマン
八上	ヤガミ
八分	ハチブ
八分目	ハチブンメ
八十	ヤソ
八十神	ヤソガミ
八千代	ヤチヨ
八卦	ハッケ
八字	ヤジ
八宝菜	ハッポウサイ
八寸	ハッスン
八巻	ヤツマキ
八幡	ヤハタ
八幡様	ハチマンサマ
八方睨み	ハッポウニラミ
八日	ヨウカ
八日目	ヨウカメ
八時	ハチジ
八月	ハチガツ
八木	ハチボク
八犬伝	ハッケンデン
八百	ヤオ
八百屋	ヤオヤ
八重桜	ヤエザクラ
八重歯	ヤエバ
八釜	ヤカマ
公	オオヤケ
公使	コウシ
公債	コウサイ
公園	コウエン
公平	コウヘイ
公式	コウシキ
公徳	コウトク
公民	コウミン
公然の秘密	コウゼンノヒミツ
公等	キミヒト
公言	コウゲン
公認	コウニン
公転	コウテン
公達	キンダチ
公開	コウカイ
六	ロク
六つ	ムッツ
六分	ロクブ
六尺	ロクシャク
六年生	ロクネンセイ
六日	ムイカ
六時	ロジ
六月	ロクガツ
六本	ロクモト
六種	ムクサ
六衛府	リクエフ
六角	ロッカク
共	トモ
共同	キョウドウ
共感	キョウカン
共有	キョウユウ
共産主義	キョウサンシュギ
共通	キョウツウ
共通点	キョウツウテン
共鳴	キョウメイ
兵	ヘイ
兵児帯	ヘコオビ
兵営	ヘイエイ
兵式体操	ヘイシキタイソウ
兵隊	ヘイタイ
具	グ
具不退転	グフタイテン
具体策	グタイサク
具合	グアイ
具合い	グアイ
典	テン
典型	テンケイ
兼	ケン
兼ね合い	カネアイ
内	ウチ
内々	ウチウチ
内侍	ナイシ
内出血	ナイシュッケツ
内外	ナイガイ
内妻	ナイサイ
内実	ナイジツ
内容	ナイヨウ
内密	ナイミツ
内幕	ウチマク
内弟子	ウチデシ
内心	ナイシン
内情	ナイジョウ
内所	ナイショ
内攻	ナイコウ
内済	ナイサイ
内省	ナイセイ
内緒	ナイショ
内縁の妻	ナイエンノツマ
内職	ナイショク
内臓	ナイゾウ
内輪	ウチワ
内部	ナイブ
内面	ナイメン
内面的	ナイメンテキ
円	エン
円タク	エンタク
円光	エンコウ
円柱	エンチュウ
円満	エンマン
円滑	エンカツ
円覚寺	エンカクジ
円転滑脱	エンテンカツダツ
冊	サツ
再会	サイカイ
再拝	サイハイ
再来	サイライ
再考	サイコウ
再興	サイコウ
冒険	ボウケン
冒頭	ボウトウ
冗談	ジョウダン
写し	ウツシ
写生	シャセイ
写生文	シャセイブン
写真	シャシン
写真撮影	シャシンサツエイ
冤罪	エンザイ
冥々	メイメイ
冥土	メイド
冥想	メイソウ
冥頑不霊	メイガンフレイ
冬	フユ
冬休み	フユヤスミ
冬瓜	トウガ
冬空	フユゾラ
冷	ヒヤ
冷え	ヒエ
冷やか	ヒヤヤカ
冷やしうどん	ヒヤシウドン
冷やし中華	ヒヤシチュウカ
冷却	レイキャク
冷奴	ヒヤヤッコ
冷水	レイスイ
冷汗	ヒヤアセ
冷汗三斗	レイカンサント
冷淡	レイタン
冷然	レイゼン
冷笑	レイショウ
冷罵	レイバ
冷評	レイヒョウ
冷酷	レイコク
冷風	レイフウ
冷麺	レイメン
冽	キヨシ
凄惨	セイサン
凌ぎ	シノギ
凌雲	リョウウン
凝結	ギョウケツ
几帳面	キチョウメン
凡て	スベテ
凡人	ボンジン
凡庸	ボンヨウ
凡眼	ボンガン
処	ショ
処分	ショブン
処刑	ショケイ
処士	ショシ
処女	ショジョ
処方	ショホウ
処決	ショケツ
処理	ショリ
処置	ショチ
凱旋	ガイセン
凱歌	ガイカ
凶作	キョウサク
凸レンズ	トツレンズ
凸凹	オウトツ
出	イズル
出し	ダシ
出して	ダシテ
出し抜け	ダシヌケ
出て	ダシテ
出で立ち	イデタチ
出はいり	デハイリ
出ろ	シュツロ
出世間	シュッセケン
出任せ	デマカセ
出先	デサキ
出入	シュツニュウ
出入り	デイリ
出入口	デイリグチ
出典	シュッテン
出処	シュッショ
出勤	シュッキン
出口	イデグチ
出合い頭	デアイガシラ
出奔	シュッポン
出帆	シュッパン
出席	シュッセキ
出張	シュッチョウ
出征	シュッセイ
出御	シュツギョ
出所	シュッショ
出来	デキ
出来事	デキゴト
出来合	デキアイ
出来心	デキゴコロ
出来損ない	デキソコナイ
出来栄	デキバエ
出汁	ダシ
出版	シュッパン
出現	シュツゲン
出発	シュッパツ
出直	デナオシ
出直し	デナオシ
出立	シュッタツ
出精	シュッセイ
出自	シュツジ
出血	シュッケツ
出身	シュッシン
出陣	シュツジン
出頭	シュットウ
出馬	シュツバ
出鱈目	デタラメ
函	ハコ
刀	カタナ
刃	ハ
刃物	ハモノ
分	ブン
分か	ブンカ
分からん	ワカラン
分たい	ブンタイ
分の	ブンノ
分らずや	ワカラズヤ
分り	ワカリ
分与	ブンヨ
分別	フンベツ
分前	ワケマエ
分子	ブンシ
分度器	ブンドキ
分捕	ブンドリ
分明	フンミョウ
分界	ブンカイ
分署	ブンショ
分解	ブンカイ
分身	ブンシン
分配	ブンパイ
分量	ブンリョウ
分間	フンカン
分際	ブンザイ
分類	ブンルイ
切	セツ
切り	キリ
切り下げ	キリサゲ
切り干し大根	キリボシダイコン
切り身	キリミ
切り通し	キリドオシ
切れ	キレ
切れめ	キレメ
切れ目	キレメ
切下	キリサゲ
切先	キッサキ
切売	キリウリ
切実	セツジツ
切手	キッテ
切支丹	キリシタン
切断	セツダン
切望	セツボウ
切符	キップ
切身	キリミ
刈	カリ
刎	ハネ
刑	ケイ
刑事	ケイジ
刑事事件	ケイジジケン
刑務所	ケイムショ
刑罰	ケイバツ
列	レツ
列仙伝	レツセンデン
列席	レッセキ
列挙	レッキョ
列車	レッシャ
初	ハツ
初め	ハジメ
初代将軍	ショダイショウグン
初冬	ショトウ
初出	ショシュツ
初夏	ショカ
初対面	ショタイメン
初心	ショシン
初志	ショシ
初恋	ハツコイ
初手	ショテ
初春	ショシュン
初期	ショキ
初版	ショハン
初秋	ショシュウ
初等	ショトウ
判事	ハンジ
判官贔屓	ハンガンビイキ
判定	ハンテイ
判断	ハンダン
判明	ハンメイ
判然	ハンゼン
別	ベツ
別れ	ワカレ
別人	ベツジン
別冊	ベッサツ
別名	ベツメイ
別嬪	ベッピン
別室	ベッシツ
別居	ベッキョ
別段	ベツダン
別物	ベツモノ
別種	ベッシュ
別荘	ベッソウ
利	リ
利かん	キカン
利き	リキ
利亜	リア
利口	リコウ
利器	リキ
利子	リシ
利害	リガイ
利己	リコ
利己主義	リコシュギ
利息	リソク
利潤	リジュン
利用	リヨウ
利益	リエキ
利目	キキメ
到来	トウライ
到着	トウチャク
制作	セイサク
制定	セイテイ
制帽	セイボウ
制度	セイド
制御	セイギョ
制服	セイフク
制裁	セイサイ
刷	スリ
刷毛	ハケ
刹那	セツナ
刺	トゲ
刺戟	シゲキ
刺激	シゲキ
刺身	サシミ
刻	コク
刻印	コクイン
刻限	コクゲン
則	ノリ
削減	サクゲン
前	マエ
前かた	マエカタ
前め	マエメ
前代未聞	ゼンダイミモン
前任	ゼンニン
前例	ゼンレイ
前列	ゼンレツ
前半	ゼンハン
前回	ゼンカイ
前夜	ゼンヤ
前後	ゼンゴ
前後不覚	ゼンゴフカク
前後左右	ゼンゴサユウ
前方	ゼンポウ
前日	ゼンジツ
前時	マエトキ
前歯	マエバ
前祝	マエイワイ
前科	ゼンカ
前置	マエオキ
前足	マエアシ
前途	ゼント
前途有望	ゼントユウボウ
前進	ゼンシン
前面	ゼンメン
前髪	マエガミ
剛	ツヨシ
剛腹	ゴウフク
剣	ケン
剣呑	ケンノン
剣突	ケンツク
剣舞	ケンブ
剣道	ケンドウ
剤	ザイ
剥	ハゲ
副詞	フクシ
剰余	ジョウヨ
割	ワリ
割り	ワリ
割前	ワリマエ
割合	ワリアイ
割愛	カツアイ
割算	ワリザン
剴切	ガイセツ
創作	ソウサク
創痕	ソウコン
創造	ソウゾウ
剽軽	ヒョウキン
剿滅	ソウメツ
劇	ゲキ
劇作家	ゲキサッカ
劇場	ゲキジョウ
劇変	ゲキヘン
劇甚	ゲキジン
劈頭	ヘキトウ
力	チカラ
力ずく	チカラズク
力任せ	チカラマカセ
力学	リキガク
力持	チカラモチ
力演	リキエン
力瘤	チカラコブ
力石	リキイシ
力量	リキリョウ
功	イサオ
功力	クリキ
功労者	コウロウシャ
功名心	コウミョウシン
功徳	クドク
功果	コウカ
功能	コウノ
加	カ
加之	カノ
加勢	カセイ
加味	カミ
加工	カコウ
加担	カタン
加減	カゲン
加盟	カメイ
加茂川	カモガワ
劣	レツ
劣情	レツジョウ
劣等	レットウ
助	スケ
助け	タスケ
助勢	ジョセイ
助太刀	スケダチ
助平	スケベエ
助役	ジョヤク
助手	ジョシュ
助言	ジョゲン
努力	ドリョク
劫	コウ
励	ハゲミ
励み	ハゲミ
労	ロウ
労力	ロウリョク
効	コウ
効力	コウリョク
効果	コウカ
効用	コウヨウ
勃然	ボツゼン
勅使	チョクシ
勇み肌	イサミハダ
勇士	ユウシ
勇気	ユウキ
勇猛	ユウモウ
勇猛精進	ユウミョウショウジン
勉強	ベンキョウ
動き	ウゴキ
動こう	ドウコウ
動作	ドウサ
動悸	ドウキ
動揺	ドウヨウ
動物	ドウブツ
動物園	トンムルウォン
動画	ドウガ
動議	ドウギ
動静	ドウセイ
勘	カン
勘太郎	カンタロウ
勘定	カンジョウ
勘定所	カンジョウショ
勘左	カンザ
勘弁	カンベン
勘当	カンドウ
勝	カチ
勝ち	カチ
勝利	ショウリ
勝手	カッテ
勝手口	カッテグチ
勝手次第	カッテシダイ
勝敗	ショウハイ
勝負	ショウブ
募集	ボシュウ
勢	ゼイ
勢い	イキオイ
勢力	セイリョク
勢揃	セイゾロイ
勢揃い	セイゾロイ
勤め	ツトメ
勤勉	キンベン
勤務	キンム
勧	ススム
勧告	カンコク
勧工場	カンコウバ
勧誘	カンユウ
勺	シャク
勾配	コウバイ
勿体	モッタイ
匂	ニオイ
匂い	ニオイ
包	ツツミ
包み	ツツミ
包丁	ホウチョウ
包含	ホウガン
包括	ホウカツ
匆々	ソウソウ
匕首	ヒシュ
化	カ
化け物	バケモノ
化の皮	バケノカワ
化学	カガク
化物	バケモノ
化石	カセキ
化粧	ケショウ
北	キタ
北の方	キタノカタ
北側	キタガワ
北十字	キタジュウジ
北国	キタグニ
北斗七星	ホクトシチセイ
北方	ホッポウ
北極	ホッキョク
北欧	ホクオウ
北限	ホクゲン
北面	ホクメン
北風	キタカゼ
匙	サジ
匡	タダシ
匹	ヒキ
匹敵	ヒッテキ
区	ク
区内	クナイ
区切り	クギリ
区別	クベツ
区劃	クカク
区域	クイキ
区民	クミン
区点	クテン
医	イ
医大	イダイ
医学	イガク
医専	イセン
医師	イシ
医者	イシャ
匿名	トクメイ
十	ジュウ
十一	トイチ
十一月	ジュウイチガツ
十七	トナ
十万	ジュウマン
十三	ジュウザ
十中八九	ジュッチュウハック
十九	ジュック
十二	ジュウニ
十二分	ジュウニブン
十二巻	ジュウニノマキ
十二時	ジュウニジ
十二月一日	ジュウニガツツイタチ
十二月四日	ジュウニガツヨッカ
十五	トウゴ
十五日	ジュウゴニチ
十人	ジュウニン
十人十色	ジュウニントイロ
十倍	トベ
十八	トワ
十六	ジュウロク
十六むさし	ジュウロクムサシ
十分	ジュウブン
十四	トシ
十字	ジュウジ
十字架	ジュウジカ
十市郡	トイチグン
十年一日	ジュウネンイチジツ
十文字	ジュウモンジ
十日	トオカ
十時	トトキ
十月	ジュウガツ
十目	ジュウモク
十行	ジュウギョウ
十間	ジツケン
千	セン
千両	センリョウ
千両箱	センリョウバコ
千人	センニン
千代	チヨ
千代紙	チヨガミ
千円	センエン
千古	センコ
千古万古	センコバンコ
千変万化	センペンバンカ
千字文	センジモン
千尋	チヒロ
千山万岳	センザンバンガク
千差万別	センサバンベツ
千年	チトセ
千疋	センビキ
千石船	センゴクブネ
千秋	センシュウ
千葉	チバ
千葉氏	チバシ
千葉県千葉市	チバケンチバシ
千葉県船橋市	チバケンフナバシシ
千載	センザイ
千載一遇	センザイイチグウ
千金	センキン
千駄木	センダギ
千鳥	チドリ
升	マス
午	ウマ
午前	ゴゼン
午后	ゴゴ
午後	ゴゴ
午睡	ゴスイ
午砲	ゴホウ
半	ハン
半々	ハンハン
半か	ハンカ
半ば	ナカバ
半ぺん	ハンペン
半兵衛	ハンベエ
半分	ハンブン
半切	ハンセツ
半可通	ハンカツウ
半夜	ハンヤ
半年	ハントシ
半径	ハンケイ
半日	ハンニチ
半月	ハンツキ
半熟	ハンジュク
半町	ハンジョウ
半紙	ハンシ
半纏	ハンテン
半袖	ハンソデ
半襟	ハンエリ
半襦袢	ハンジュバン
半身	ハンシン
半面	ハンメン
卑劣	ヒレツ
卑屈	ヒクツ
卑怯	ヒキョウ
卑猥	ヒワイ
卑見	ヒケン
卒	ソツ
卒中	ソッチュウ
卒倒	ソットウ
卒塔婆	ソトウバ
卒業	ソツギョウ
卒業の日	ソツギョウノヒ
卒業式	ソツギョウシキ
卒業後	ソツギョウゴ
卒業生	ソツギョウセイ
卒業祝い	ソツギョウイワイ
卒業証書	ソツギョウショウショ
卒業論文	ソツギョウロンブン
卒然	ソツゼン
卓	タク
卓上	タクジョウ
卓子	タカコ
卓治	タクジ
協会	キョウカイ
協力	キョウリョク
協商	キョウショウ
協賛	キョウサン
南	ミナミ
南下	ナンカ
南伊豆	ミナミイズ
南側	ミナミガワ
南十字	ミナミジュウジ
南向	ナンコウ
南条氏	ナンジョウシ
南無阿弥陀仏	ナムアミダブツ
南瓜	カボチャ
南蔵院	ナンゾウイン
南蛮	ナンバン
南部	ナンブ
南郷	ナンゴウ
南隣	ナンリン
単独	タンドク
単簡	タンカン
単純	タンジュン
単衣	ヒトエ
単語	タンゴ
単調	タンチョウ
博士	ハカセ
博士論文	ハクシロンブン
博多	ハカタ
博学	ハクガク
博物	ハクブツ
博物館	ハクブツカン
卜	ボク
占領	センリョウ
印	シルシ
印刷	インサツ
印度	インド
印形	インギョウ
印材	インザイ
印籠	インロウ
印象	インショウ
印象派	インショウハ
印鑑	インカン
危き	キキ
危く	キク
危害	キガイ
危惧	キグ
危懼	キク
危機一髪	キキイッパツ
危篤	キトク
危険	キケン
即ち	スナワチ
即効	ソッコウ
即夜	ソクヤ
即席	ソクセキ
即座	ソクザ
即答	ソクトウ
卵	タマゴ
卵焼き	タマゴヤキ
卸	オロシ
卸売	オロシウリ
卸売価格	オロシウリカカク
厄	ワザワイ
厄介	ヤッカイ
厄介者	ヤッカイモノ
厘	リン
厚	アツ
厚意	コウイ
厚狭	アサ
厚狭駅	アサエキ
厚遇	コウグウ
原	ハラ
原則	ゲンソク
原因	ゲンイン
原始的	ゲンシテキ
原泉	ハライズミ
原理	ゲンリ
原稿	ゲンコウ
原稿用紙	ゲンコウヨウシ
原色	ゲンショク
原論	ゲンロン
原資	ゲンシ
厠	カワヤ
厨	クリヤ
厨子	ズシ
厩	ウマヤ
厭	イヤ
厭き	アキ
厭世	エンセイ
厭味	イヤミ
厳	イム
厳命	ゲンメイ
厳寒	ゲンカン
厳格	ゲンカク
厳粛	ゲンシュク
厳罰	ゲンバツ
厳重	ゲンジュウ
去年	キョネン
去来	キョライ
参	サン
参か	サンカ
参上	サンジョウ
参列	サンレツ
参列者	サンレツシャ
参加	サンカ
参堂	サンドウ
参照	サンショウ
参考	サンコウ
参考文献	サンコウブンケン
参考書	サンコウショ
参観	サンカン
参詣	サンケイ
参酌	サンシャク
叉	マタ
及	イタル
及第	キュウダイ
友	トモ
友だち	トモダチ
友人	ユウジン
友情	ユウジョウ
友愛	ユウアイ
友達	トモダチ
双六	スゴロク
双子	フタゴ
双子葉植物	ソウシヨウショクブツ
双幅	ソウフク
双方	ソウホウ
双眸	ソウボウ
反り	ソリ
反動	ハンドウ
反古	ホゴ
反問	ハンモン
反対	ハンタイ
反射	ハンシャ
反応	ハンノウ
反感	ハンカン
反抗	ハンコウ
反撥	ハンパツ
反映	ハンエイ
反比例	ハンピレイ
反照	ハンショウ
反物	タンモノ
反省	ハンセイ
反覆	ハンプク
反身	ソリミ
反転	ハンテン
反響	ハンキョウ
反駁	ハンバク
収	オサム
収入	シュウニュウ
収容	シュウヨウ
収益	シュウエキ
収縮	シュウシュク
収載	シュウサイ
収集	シュウシュウ
叔母	オバ
叔母さん	オバサン
叔父	オジ
叔父さん	オジサン
取って	トッテ
取り	トリ
取りかえし	トリカエシ
取りつき	トリツキ
取り付き	トリツキ
取り得	トリドク
取り扱	トリアツカイ
取り消し	トリケシ
取り立て	トリタテ
取り返し	トリカエシ
取付	トリツケ
取合せ	トリアワセ
取扱	トリアツカイ
取扱い	トリアツカイ
取次	トリツギ
取残	トリノコシ
取消	トリケシ
取締	トリシマリ
取計	トリハカライ
取計らい	トリハカライ
取調べ	トリシラベ
取越苦労	トリコシグロウ
取返し	トリカエシ
受けて	ウケテ
受け答え	ウケコタエ
受け身	ウケミ
受取り	ウケトリ
受合	ウケアイ
受売	ウケウリ
受容	ジュヨウ
受持	ウケモチ
受持ち	ウケモチ
受理	ジュリ
受納	ジュノウ
受験	ジュケン
受験勉強	ジュケンベンキョウ
叙	ジョ
叙述	ジョジュツ
叡山	エイザン
叡智	エイチ
口	クチ
口々	クチグチ
口づけ	クチヅケ
口上	コウジョウ
口中	クチジュウ
口付き	クチツキ
口元	クチモト
口先	クチサキ
口取	クチトリ
口吻	コウフン
口外	コウガイ
口実	コウジツ
口振	クチブリ
口数	クチカズ
口気	コウキ
口癖	クチグセ
口笛	クチブエ
口紅	クチベニ
口絵	クチエ
口舌	コウゼツ
口調	クチョウ
口論	コウロン
口金	クチガネ
古	フル
古井	フルイ
古人	コジン
古今	ココン
古今独歩	ココンドッポ
古代	コダイ
古史	コシ
古城町	コジョウマチ
古川	フルカワ
古往今来	コオウコンライ
古本屋	フルホンヤ
古来	コライ
古池	フルイケ
古沼	コヌマ
古流	コリュウ
古渡	コワタリ
古物	フルモノ
古狸	フルダヌキ
古町	フルマチ
古着	フルギ
古語	コゴ
古賀	コガ
古雅	コガ
古風	コフウ
句	ク
句読	クトウ
只	タダ
只事	タダゴト
只今	タダイマ
叫び	サケビ
叫び声	サケビゴエ
召使	メシツカイ
召使い	メシツカイ
叮嚀	テイネイ
可	カ
可哀そう	カワイソウ
可哀想	カワイソウ
可哀相	カワイソウ
可憐	カレン
可能	カノウ
台	ダイ
台なし	ダイナシ
台の下	ダイノシタ
台場	ダイバ
台所	ダイドコロ
台湾	タイワン
台町	ダイマチ
史	フミ
右	ミギ
右側	ミギガワ
右向	ミギムキ
右大臣	ウダイジン
右左	ミギヒダリ
右往左往	ウオウサオウ
右手	ミギテ
右腕	ウワン
右衛門	ウエモン
号	ゴウ
号令	ゴウレイ
号外	ゴウガイ
号砲	ゴウホウ
吃驚	ビックリ
各々	オノオノ
各位	カクイ
各地	カクチ
各社	カクシャ
各自	カクジ
各部	カクブ
合	ゴウ
合い	ゴウイ
合せ	アワセ
合の子	アイノコ
合併	ガッペイ
合唱	ガッショウ
合図	アイズ
合奏	ガッソウ
合戦	カッセン
合掌	ガッショウ
合板	ゴウハン
合格	ゴウカク
合法	ゴウホウ
合点	ガテン
合理的	ゴウリテキ
合計	ゴウケイ
合間	アイマ
吉備団子	キビダンゴ
吉原	ヨシハラ
吉川	ヨシカワ
吉田	ヨシダ
吉野紙	ヨシノガミ
同じ	オナジ
同じく	ドウジク
同一	ドウイツ
同上	ドウジョウ
同人	ドウジン
同人活動	ドウジンカツドウ
同勢	ドウゼイ
同君	ドウクン
同型	ドウケイ
同士	ドウシ
同室	ドウシツ
同宿	ドウシュク
同居	ドウキョ
同年輩	ドウネンパイ
同座	ドウザ
同志	ドウシ
同性	ドウセイ
同情	ドウジョウ
同意	ドウイ
同感	ドウカン
同断	ドウダン
同族	ドウゾク
同日	ドウジツ
同時	ドウジ
同棲	ドウセイ
同様	ドウヨウ
同気相求	ドウキソウキュウ
同然	ドウゼン
同盟	ドウメイ
同窓	ドウソウ
同等	ドウトウ
同級	ドウキュウ
同級生	ドウキュウセイ
同義語	ドウギゴ
同行	ドウコウ
同衾	ドウキン
同輩	ドウハイ
同郷	ドウキョウ
同類	ドウルイ
同類相求	ドウルイソウキュウ
名	ナ
名なし	ナナシ
名はない	ナハナイ
名主	ナヌシ
名乗り	ナノリ
名人	メイジン
名僧	メイソウ
名優	メイユウ
名刀	メイトウ
名刺	メイシ
名刺入れ	メイシイレ
名前	ナマエ
名医	メイイ
名古屋	ナゴヤ
名宛	ナアテ
名折れ	ナオレ
名文	メイブン
名札	ナフダ
名案	メイアン
名残り	ナゴリ
名状	メイジョウ
名産	メイサン
名目	メイモク
名称	メイショウ
名立町	ナダチマチ
名筆	メイヒツ
名答	メイトウ
名簿	メイボ
名詞	メイシ
名誉	メイヨ
名論	メイロン
吐き気	ハキケ
吐出	トシュツ
吐月峰	トゲッポウ
吐気	ハキケ
向	ムカイ
向い	ムカイ
向い合	ムカイアワセ
向い合せ	ムカイアワセ
向う	ムコウ
向う側	ムコウガワ
向う岸	ムコウギシ
向き	ムキ
向け	ムケ
向こう	ムコウ
向上	コウジョウ
向上心	コウジョウシン
向側	ムコウガワ
向島	ムコウジマ
向後	コウゴ
君	キミ
君たち	キミタチ
君と僕	キミトボク
君について	キミニツイテ
君の名前	キミノナマエ
君の国	キミノクニ
君の詩	キミノウタ
君の話	キミノハナシ
君は夏	キミハナツ
君代	キミヨ
君大	キミヒロ
君子	クンシ
君気	キミオキ
君等	キミヒト
君羅	キミラ
君臣	クンシン
吝嗇	リンショク
吟	ギン
否	イナ
否でも応でも	イヤデモオウデモ
否や	イナヤ
否定	ヒテイ
含嗽	ガンソウ
吶喊	トッカン
吸い殻	スイガラ
吸い物	スイモノ
吸収	キュウシュウ
吸口	スイクチ
吹きつけ	フキツケ
吹き寄せ	フキヨセ
吹き矢	フキヤ
吹聴	フイチョウ
吾	ワレ
吾妻	アヅマ
吾妻橋	アズマバシ
吾輩	ワガハイ
吾輩は猫である	ワガハイハネコデアル
呂	リョ
呂律	ロレツ
呆然	ボウゼン
呈	テイ
呈出	テイシュツ
呉服	ゴフク
呉服屋	ゴフクヤ
呉絽	ゴロ
告別	コクベツ
告朔	コウサク
告白	コクハク
告訴	コクソ
呑み込み	ノミコミ
呑気	ノンキ
呑舟	ドンシュウ
周	シュウ
周り	マワリ
周囲	シュウイ
周密	シュウミツ
周旋	シュウセン
呪い	ノロイ
味	アジ
味の素	アジノモト
味噌	ミソ
味噌ラーメン	ミソラーメン
味噌汁	ミソシル
味噌煮込みうどん	ミソニコミウドン
味方	ミカタ
味気	アジケ
呵責	カシャク
呻吟	シンギン
呼	コ
呼ばわり	ヨバワリ
呼吸	コキュウ
呼子	ヨビコ
命	イノチ
命中	メイチュウ
命令	メイレイ
命取り	イノチトリ
命名	メイメイ
命懸け	イノチガケ
命題	メイダイ
咀嚼	ソシャク
咄	ハナシ
咄嗟	トッサ
和	ワ
和かい	ワカイ
和名	ワメイ
和唐	ワトウ
和尚	オショウ
和歌	ワカ
和製	ワセイ
和邇	ワニ
和風サラダ	ワフウサラダ
和風ドレッシング	ワフウドレッシング
和食	ワショク
咎	トガ
咎め立	トガメダテ
咎め立て	トガメダテ
咳	セキ
咳ばらい	セキバライ
咳払	セキバライ
咳払い	セキバライ
咽	ノンド
咽喉	インコウ
哀れ	アワレ
哀悼	アイトウ
哀愁	アイシュウ
哀願	アイガン
品	シナ
品位	ヒンイ
品切れ	シナギレ
品川	シナガワ
品性	ヒンセイ
品数	シナカズ
品格	ヒンカク
品物	シナモノ
品目	ヒンモク
品種	ヒンシュ
品行	ヒンコウ
哉	カナ
員	イン
哲人	テツジン
哲学	テツガク
哲学者	テツガクシャ
哲理	テツリ
哺乳類	ホニュウルイ
唄	ウタ
唇	クチビル
唐	トウ
唐めい	トウメイ
唐人	トウジン
唐変木	トウヘンボク
唐揚げ	カラアゲ
唐木	トウボク
唐桟	トウザン
唐檜	トウヒ
唐津	カラツ
唐物	トウブツ
唐皮	カラカワ
唐突	トウトツ
唐紙	カラカミ
唐縮緬	トウチリメン
唐茄子	トウナス
唐草	カラクサ
唐詩選	トウシセン
唐辛子	トウガラシ
唖	オシ
唯々	イイ
唯一	ユイイツ
唯物論	ユイブツロン
唱導	ショウドウ
唱歌	ショウカ
唱道	ショウドウ
唾	ツバ
唾液	ダエキ
商	ショウ
商人	ショウニン
商売	ショウバイ
商業	ショウギョウ
商業学校	ショウギョウガッコウ
問	トイ
問い	トイ
問屋	トンヤ
問答	モンドウ
問題	モンダイ
啓	ケイ
喀血	カッケツ
善	ゼン
善い	ヨイ
善し悪し	ヨシアシ
善は急げ	ゼンハイソゲ
善人	ゼンニン
善兵衛	ゼンベエ
善後	ゼンゴ
善悪	ゼンアク
善意	ゼンイ
善良	ゼンリョウ
善行	ゼンコウ
喇叭	ラッパ
喉	ノド
喉仏	ノドボトケ
喉笛	ノドブエ
喋	チョウ
喋々	チョウチョウ
喚起	カンキ
喜	キ
喜び	ヨロコビ
喜劇	キゲキ
喜多	キタ
喜悦	キエツ
喝	カツ
喝采	カッサイ
喧嘩	ケンカ
喧嘩腰	ケンカゴシ
喩	ユイ
喩え	タトエ
喪失	ソウシツ
喪失感	ソウシツカン
喪家	ソウカ
喫茶店	キッサテン
喬木	タカギ
喰代	ホウジロ
営み	イトナミ
営所	エイショ
営業	エイギョウ
営養	エイヨウ
嗅覚	キュウカク
嗜好	シコウ
嘆息	タンソク
嘆賞	タンショウ
嘆願	タンガン
嘔吐	オウト
嘘	ウソ
嘘つき	ウソツキ
嘘八百	ウソハッピャク
嘲笑	チョウショウ
嘴	クチバシ
噂	ウワサ
器	ウツワ
器械	キカイ
器用	キヨウ
器量	キリョウ
噴出	フンシュツ
噴火山	フンカザン
噺	ハナシ
嚆矢	コウシ
嚔	クサメ
嚢中	ノウチュウ
嚥	エン
囁き	ササヤキ
囃子	ハヤシ
囚人	シュウジン
四	ヨン
四つ	ヨッツ
四つ目	ヨツメ
四つ角	ヨツカド
四ツ目	ヨツメ
四丁	シチョウ
四丁目	ヨンチョウメ
四六時中	シロクジチュウ
四分	シブ
四十	ヨト
四十三	シジュウサン
四十九	シジュウク
四十八	シトヤ
四十四	シトシ
四半分	シハンブン
四国	シコク
四国新聞	シコクシンブン
四年生	ヨネンセイ
四方	シホウ
四方八方	シホウハッポウ
四日	ヨッカ
四月	シガツ
四本	ヨツモト
四海天下	シカイテンカ
四畳半	ヨジョウハン
四百四病	シヒャクシビョウ
四肢	シシ
四角	シカク
四辺	シヘン
四隅	ヨスミ
四隣	シリン
回	カイ
回り	マワリ
回向	エコウ
回向院	エコウイン
回復	カイフク
回想	カイソウ
回避	カイヒ
回鍋肉	ホイコーロ
回顧	カイコ
因	イン
因循	インジュン
因果	インガ
因業	インゴウ
因縁	インネン
因襲	インシュウ
団体	ダンタイ
団子	ダンゴ
団子屋	ダンゴヤ
団扇	ウチワ
団栗	ドングリ
困却	コンキャク
困憊	コンパイ
困窮	コンキュウ
困苦	コンク
困難	コンナン
囲	カコイ
囲い	カコイ
囲炉裏	イロリ
囲碁	イゴ
囲繞	イジョウ
図	ズ
図書館	トショカン
図案	ズアン
図画	ズガ
固守	コシュ
固形	コケイ
固有	コユウ
国	クニ
国事	コクジ
国元	クニモト
国名	コクメイ
国境	コッキョウ
国家	コッカ
国師	コクシ
国旗	コッキ
国柄	クニガラ
国民	コクミン
国産	コクサン
国語	コクゴ
国賊	コクゾク
国際	コクサイ
園	エン
園芸	エンゲイ
園芸品種	エンゲイヒンシュ
園遊会	エンユウカイ
團子	ダンゴ
土	ド
土中	ドチュウ
土佐	トサ
土俵	ドヒョウ
土俵際	ドヒョウギワ
土偶	ドグウ
土台	ドダイ
土器	ドキ
土地	トチ
土地柄	トチガラ
土塀	ドベイ
土手	ドテ
土手三番町	ドテサンバンチョウ
土手下	ドテシタ
土曜	ドヨウ
土産	ミヤゲ
土産もの	ミヤゲモノ
土用	ドヨウ
土百姓	ドビャクショウ
土砂災害	ドシャサイガイ
土管	ドカン
土間	ドマ
圧し	オシ
圧倒	アットウ
圧迫	アッパク
在	ザイ
在処	アリカ
在天	ザイテン
在宅	ザイタク
在宿	ザイシュク
在巣	アリス
在所	ザイショ
在来	ザイライ
在校	ザイコウ
地	チ
地べた	ジベタ
地上	チジョウ
地下	チカ
地下鉄道	チカテツドウ
地中	チチュウ
地位	チイ
地区	チク
地名	チメイ
地味	ジミ
地図	チズ
地域	チイキ
地域別	チイキベツ
地層	チソウ
地帯	チタイ
地平線	チヘイセン
地形	チケイ
地方	チホウ
地方税	チホウゼイ
地獄	ジゴク
地獄の業火	ジゴクノゴウカ
地獄の門	ジゴクノモン
地球	チキュウ
地理	チリ
地蔵	ジゾウ
地軸	チジク
地道	ジミチ
地金	ジガネ
地震	ジシン
地面	ジメン
坂	サカ
坂の下	サカノシタ
坂本竜馬	サカモトリョウマ
坂路	サカジ
均一	キンイツ
坊	ボウ
坊さん	ボウサン
坊ちゃん	ボッチャン
坊っちゃん	ボッチャン
坊や	ボウヤ
坊主	ボウズ
坊主頭	ボウズアタマ
坐り	スワリ
坐禅	ザゼン
坪	ツボ
垂れ	タレ
垂涎	スイゼン
型	カタ
垢	アカ
垢抜け	アカヌケ
垢擦り	アカスリ
垣	カキ
垣根	カキネ
垣根越し	カキネゴシ
埃	ホコリ
埃及	エジプト
埋合せ	ウメアワセ
城	シロ
城下	ジョウカ
城主	ジョウシュ
城壁	ジョウヘキ
埒	ラチ
域	イキ
執拗	シツヨウ
執着	シュウチャク
執着心	シュウチャクシン
執筆	シッピツ
執行	シッコウ
基	モト
基本	キホン
基点	キテン
基督教	キリストキョウ
基調	キチョウ
埼玉	サイタマ
堀	ホリ
堀川	ホリカワ
堀木	ホリキ
堀田	ホッタ
堂	ドウ
堅気	カタギ
堅炭	カタズミ
堕落	ダラク
堤	ツツミ
堤防	テイボウ
堪能	タンノウ
堰	セキ
報	ホウ
報告	ホウコク
報知	ホウチ
報道	ホウドウ
報酬	ホウシュウ
場	バ
場うて	バウテ
場内	ジョウナイ
場合	バアイ
場所	バショ
場末	バスエ
堵	ト
塀	ヘイ
塊	カタマリ
塔婆	トウバ
塗	ヌリ
塗り	ヌリ
塗り絵	ヌリエ
塗り薬	ヌリグスリ
塗抹	トマツ
塗箸	ヌリバシ
塞ぎ	フサギ
塩	シオ
塩コショウ	シオコショウ
塩ラーメン	シオラーメン
塩気	シオケ
塩水	エンスイ
塩焼	シオヤキ
塩焼き	シオヤキ
塵	チリ
塾	ジュク
境	サカイ
境内	ケイダイ
境界	キョウカイ
境遇	キョウグウ
墓	ハカ
墓参	ボサン
墓参り	ハカマイリ
墓地	ボチ
墓場	ハカバ
墓標	ボヒョウ
墓石	ハカイシ
墓碑銘	ボヒメイ
増	ゾウ
増し	マシ
増上慢	ゾウジョウマン
増俸	ゾウホウ
増加	ゾウカ
増大	ゾウダイ
増殖	ゾウショク
増減	ゾウゲン
増給	ゾウキュウ
増長	ゾウチョウ
墨	スミ
墨守	ボクシュ
墳墓	フンボ
墻	カキ
壁	カベ
壁際	カベギワ
壇ノ浦	ダンノウラ
士	シ
士官	シカン
士官学校	シカンガッコウ
士族	シゾク
壮	タケシ
壮士	ソウシ
壮快	ソウカイ
壮観	ソウカン
声	コエ
声が出ない	コエガデナイ
声援	セイエン
壱	イチ
売	ウ
売れ残り	ウレノコリ
売却	バイキャク
売品	バイヒン
売渡	ウリワタシ
売薬	バイヤク
売買	バイバイ
壺	ツボ
変	ヘン
変ち	ヘンチ
変り	カワリ
変り者	カワリモノ
変人	ヘンジン
変化	ヘンカ
変形	ヘンケイ
変心	ヘンシン
変更	ヘンコウ
変死	ヘンシ
変物	ヘンブツ
変種	ヘンシュ
変色	ヘンショク
変調	ヘンチョウ
変貌	ヘンボウ
変遷	ヘンセン
夏	ナツ
夏の夜	ナツノヨル
夏みかん	ナツミカン
夏休み	ナツヤスミ
夏冬	ナツフユ
夏服	ナツフク
夏目漱石	ナツメソウセキ
夏蜜柑	ナツミカン
夏野菜	ナツヤサイ
夕	ユウ
夕ごはん	ユウゴハン
夕べ	ユウベ
夕方	ユウガタ
夕暮	ユウグレ
夕月	ユウヅキ
夕焼け	ユウヤケ
夕立	ユウダチ
夕立ち	ユウダチ
夕闇	ユウヤミ
夕陽	ユウヒ
夕食	ユウショク
夕飯	ユウハン
外	ソト
外れ	ハズレ
外側	ソトガワ
外出	ガイシュツ
外国	ガイコク
外套	ガイトウ
外字	ガイジ
外来種	ガイライシュ
外泊	ガイハク
外濠	ソトボリ
外界	ガイカイ
外聞	ガイブン
外行	ソトユキ
外見	ガイケン
外観	ガイカン
外部	ガイブ
外郭	ガイカク
外面	ガイメン
多	オオ
多々良	タタラ
多く	オオク
多事	タジ
多人数	タニンズウ
多勢	タゼイ
多勢に無勢	タゼイニブゼイ
多妻	タサイ
多少	タショウ
多年	タネン
多弁	タベン
多忙	タボウ
多情	タジョウ
多情多恨	タジョウタコン
多感多恨	タカンタコン
多田	タダ
多田満仲	タダノマンジュウ
多病	タビョウ
多祥	タショウ
多良	タラ
多角	タカク
多角形	タカッケイ
多量	タリョウ
夜	ヨル
夜なか	ヨナカ
夜なが	ヨナガ
夜中	ヨナカ
夜光	ヤコウ
夜具	ヤグ
夜回り	ヨマワリ
夜寒	ヨサム
夜市	ヤジ
夜店	ヨミセ
夜明	ヨアケ
夜明け	ヨアケ
夜昼	ヨルヒル
夜景	ヤケイ
夜更け	ヨフケ
夜桜	ヨザクラ
夜番	ヨバン
夜目	ヨメ
夜着	ヨギ
夜空	ヨゾラ
夜襲	ヤシュウ
夜遊	ヨアソビ
夜遊び	ヨアソビ
夜道	ヨミチ
夜長	ヨナガ
夜間	ヤカン
夜間学校	ヤカンガッコウ
夜陰	ヤイン
夜露	ヨツユ
夜食	ヤショク
夢	ユメ
夢じゃない	ユメジャナイ
夢の中	ユメノナカ
夢の中から	ユメノナカカラ
夢の国	ユメノクニ
夢中	ムチュウ
夢幻	ムゲン
大	ダイ
大すき	ダイスキ
大て	オオテ
大の字	ダイノジ
大もの	オオモノ
大丈夫	ダイジョウブ
大丸	ダイマル
大久保	オオクボ
大事	ダイジ
大事件	ダイジケン
大人	オトナ
大人気	ダイニンキ
大会	タイカイ
大伴	オオトモ
大伴御行	オオトモノミユキ
大体	ダイタイ
大僧	オオソウ
大儀	タイギ
大兄	タイケイ
大入	オオイリ
大八洲	オオヤシマ
大刀	タチ
大分	オオイタ
大分県	オオイタケン
大分類	ダイブンルイ
大切	タイセツ
大切なもの	タイセツナモノ
大勢	タイセイ
大半	タイハン
大厄	タイヤク
大原	オオハラ
大同小異	ダイドウショウイ
大名	ダイミョウ
大和国	ヤマトノクニ
大和魂	ヤマトダマシイ
大喜	ダイキ
大国	タイコク
大国主神	オオクニヌシノカミ
大地	ダイチ
大地震	オオジシン
大声	オオゴエ
大変	タイヘン
大好き	ダイスキ
大威	オオイ
大嫌	ダイキライ
大嫌い	ダイキライ
大学	ダイガク
大学時代	ダイガクジダイ
大学校	ダイガッコウ
大学生	ダイガクセイ
大学院	ダイガクイン
大家	オオヤ
大将	タイショウ
大小	ダイショウ
大層	タイソウ
大岩	オオイワ
大島紬	オオシマツムギ
大川	オオカワ
大工	ダイク
大差	タイサ
大師	ダイシ
大幅	オオハバ
大平	オオヒラ
大庭	オオバ
大当り	オオアタリ
大息	タイソク
大悟	タイゴ
大成功	ダイセイコウ
大戦	タイセン
大戦争	ダイセンソウ
大戸	オオド
大手	オオテ
大手町	オオテマチ
大抵	タイテイ
大振り	オオブリ
大掃除	オオソウジ
大掾	ダイジョウ
大方	オオカタ
大日本	ダイニッポン
大明	ダイメイ
大明神	ダイミョウジン
大根	ダイコン
大根卸	ダイコンオロシ
大森	オオモリ
大概	タイガイ
大樹	ダイキ
大正	タイショウ
大死一番	ダイシイチバン
大気	タイキ
大水	ダイスイ
大河	タイガ
大洋	タイヨウ
大海	オオウミ
大源	ダイゲン
大炊寮	オオイリョウオオイノツカサオホイ
大熊	オオクマ
大王	ダイオウ
大町	オオマチ
大町桂月	オオマチケイゲツ
大病	タイビョウ
大病人	ダイビョウニン
大発見	ダイハッケン
大目	オオメ
大磯	オオイソ
大礼	タイレイ
大神楽	オオカグラ
大福	ダイフク
大穴	オオアナ
大空	オオゾラ
大空大地	オオゾラダイチ
大笑	オオワライ
大笑い	オオワライ
大筋	オオスジ
大納言	ダイナゴン
大義名分	タイギメイブン
大股	オオマタ
大胆	ダイタン
大臣	ダイジン
大船	オオブネ
大蒜	ニンニク
大蔵卿	オオクラノカミ
大袈裟	オオゲサ
大観	タイカン
大詔	タイショウ
大豆	ダイズ
大象	タイゾウ
大辞林	ダイジリン
大通り	オオドオリ
大道	ダイドウ
大部	オオブ
大部分	ダイブブン
大都会	ダイトカイ
大金持ち	オオガネモチ
大釜	オオカマ
大長	オオチョウ
大間	オオマ
大隈	オオクマ
大隊	ダイタイ
大雪	オオユキ
大音	オオト
大頭	オオズ
大風呂敷	オオブロシキ
大飯	オオイ
大騒ぎ	オオサワギ
大鬼	オオオニ
大鵬	タイホウ
大鷹	オオタカ
大黒柱	ダイコクバシラ
天	テン
天が下	アメガシタ
天の川	アマノガワ
天の橋立	アマノハシダテ
天の河	アマノガワ
天の羽衣	アマノハゴロモ
天ぷら	テンプラ
天上	テンジョウ
天下	テンカ
天下わけ目	テンカワケメ
天主	テンシュ
天丼	テンドン
天井	テンジョウ
天人	テンニン
天体	テンタイ
天保	テンポウ
天保銭	テンポウセン
天命	テンメイ
天国	テンゴク
天地	テンチ
天地万有	テンチバンユウ
天地玄黄	テンチゲンコウ
天地開闢	テンチカイビャク
天女	テンニョ
天子	テンシ
天寿	テンジュ
天性	テンセイ
天意	テンイ
天才	テンサイ
天探女	アメノサグメ
天文学者	テンモンガクシャ
天日	テンジツ
天明	テンメイ
天来	テンライ
天気	テンキ
天気輪	テンキリン
天水桶	テンスイオケ
天涯	テンガイ
天然	テンネン
天然痘	テンネントウ
天狗	テング
天璋院	テンショウイン
天皇	テンノウ
天目	テンモク
天真爛漫	テンシンランマン
天祐	テンユウ
天神様	テンジンサマ
天秤棒	テンビンボウ
天稟	テンピン
天網	テンモウ
天罰	テンバツ
天職	テンショク
天蚕	テンサン
天誅	テンチュウ
天辺	テッペン
天道	テントウ
天長節	テンチョウセツ
天降	アマクダリ
天麩羅	テンプラ
太	フトシ
太人	タイト
太刀	タチ
太古	タイコ
太宰	ダザイ
太宰治	ダザイオサム
太巻き	フトマキ
太平	タイヘイ
太平楽	タイヘイラク
太政大臣	ダジョウダイジン
太神楽	ダイカグラ
太織	フトオリ
太郎	タロウ
太陽	タイヨウ
太鼓	タイコ
夫	オット
夫人	フジン
夫婦	フウフ
夫婦づれ	フウフヅレ
夫婦喧嘩	フウフゲンカ
夫婦連	フウフヅレ
夫子	フウシ
夭折	ヨウセツ
失	シツ
失体	シッタイ
失念	シツネン
失恋	シツレン
失敗	シッパイ
失敗談	シッパイダン
失敬	シッケイ
失敬千万	シッケイセンバン
失明	シツメイ
失望	シツボウ
失格	シッカク
失礼	シツレイ
失笑	シッショウ
失策	シッサク
失言	シツゲン
奄美大島	アマミオオシマ
奇	キ
奇人	キジン
奇問	キモン
奇妙	キミョウ
奇怪	キカイ
奇抜	キバツ
奇特	キトク
奇異	キイ
奇行	キコウ
奇術師	キジュツシ
奇観	キカン
奇言	キゲン
奇談	キダン
奇警	キケイ
奇蹟	キセキ
奇麗	キレイ
奈良の大仏	ナラノダイブツ
奉仕	ホウシ
奉公	ホウコウ
奉呈	ホウテイ
奉天	ホウテン
奉職	ホウショク
奉行	ブギョウ
奉賀	ホウガ
奏	ソウ
契約	ケイヤク
契約履行	ケイヤクリコウ
契約者	ケイヤクシャ
奔命	ホンメイ
奔走	ホンソウ
奥	オク
奥さま	オクサマ
奥さん	オクサン
奥の間	オクノマ
奥山	オクヤマ
奥州藤原氏	オウシュウフジワラシ
奥底	オクソコ
奥座敷	オクザシキ
奥方	オクガタ
奥様	オクサマ
奥歯	オクバ
奥行	オクユキ
奥行き	オクユキ
奨励	ショウレイ
奮然	フンゼン
奮発	フンパツ
奮闘	フントウ
女	オンナ
女なん	ジョナン
女に	オンナニ
女の子	オンナノコ
女の顔	オンナノカオ
女中	ジョチュウ
女人	ニョニン
女児	ジョジ
女史	ジョシ
女大学	オンナダイガク
女子	ジョシ
女子大	ジョシダイ
女学校	ジョガッコウ
女学生	ジョガクセイ
女官	ニョカン
女形	オンナガタ
女性	ジョセイ
女性的	ジョセイテキ
女性観	ジョセイカン
女房	ニョウボウ
女生徒	ジョセイト
女給	ジョキュウ
女連	ウナツラ
女道楽	オンナドウラク
女郎	ジョロウ
奴	ヤツ
奴さん	ヤッコサン
奴ら	ヤツラ
奴凧	ヤッコダコ
奴等	ヤツラ
奴輩	ドハイ
奴隷	ドレイ
奸物	カンブツ
好い	ヨイ
好い加減	ヨイカゲン
好かん	コウカン
好き	スキ
好きだ	スキダ
好きだから	スキダカラ
好き嫌い	スキキライ
好み	コノミ
好事家	コウズカ
好人物	コウジンブツ
好例	コウレイ
好奇	コウキ
好奇心	コウキシン
好意	コウイ
好意的	コウイテキ
好材料	コウザイリョウ
好漢	コウカン
好物	コウブツ
好男子	コウダンシ
好色	コウショク
好逑	コウキュウ
好都合	コウツゴウ
如く	ゴトク
如何	イカ
如是	ニョゼ
妄り	ミダリ
妊娠	ニンシン
妓楼	ギロウ
妖怪	ヨウカイ
妙	ミョウ
妙味	ミョウミ
妙手	ミョウシュ
妙案	ミョウアン
妙薬	ミョウヤク
妙諦	ミョウテイ
妙音	ミョウオン
妙齢	ミョウレイ
妥協	ダキョウ
妥当	ダトウ
妨害	ボウガイ
妹	イモウト
妻	ツマ
妻君	サイクン
妻子	サイシ
妾	ソバメ
姉	アネ
姉さん	ネエサン
姉たち	アネタチ
姉弟	シテイ
姉御	アネゴ
始	ハジメ
始まったな	ハジマッタナ
始まり	ハジマリ
始め	ハジメ
始末	シマツ
始業	シギョウ
姑息	コソク
姓	セイ
姓名	セイメイ
委	イ
委任	イニン
委細	イサイ
姥子	ウバコ
姪	メイ
姫	ヒメ
姫小松	ヒメコマツ
姿	スガタ
姿勢	シセイ
姿態	シタイ
威信	イシン
威光	イコウ
威力	イリョク
威勢	イセイ
威厳	イゲン
威嚇	イカク
威圧	イアツ
娑婆	シャバ
娑婆気	シャバケ
娘	ムスメ
娘と私	ムスメトワタシ
娯楽	ゴラク
娼家	ショウカ
婆	ババ
婆さん	バアサン
婚	コン
婚儀	コンギ
婚姻	コンイン
婦	フ
婦人	フジン
婦人会	フジンカイ
婦女	フジョ
婦女子	フジョシ
婿	ムコ
婿取婚	ムコトリコン
媒酌人	バイシャクニン
媚	コビ
媼	オウナ
嫁	ヨメ
嫁姑	ヨメシュウトメ
嫉妬	シット
嫉妬心	シットシン
嫌	イヤ
嫌い	キライ
嫌悪	ケンオ
嫗	オウナ
嫦娥	ジョウガ
嫩葉	ドンヨウ
嬉し涙	ウレシナミダ
嬢	ジョウ
子	コ
子ども	コドモ
子どもたち	コドモタチ
子供	コドモ
子供たち	コドモタチ
子供達	コドモタチ
子供部屋	コドモベヤ
子分	コブン
子安貝	コヤスガイ
子猫	コネコ
子規	シキ
孑孑	ボウフラ
孔	アナ
孔子	コウシ
孔平	コウヘイ
孔明	ヒロアキ
孔雀	クジャク
字	ジ
字下げ	ジサゲ
字典	ジテン
字引	ジビキ
字画	ジカク
字義	ジギ
存	ソン
存じ	ゾンジ
存分	ゾンブン
存在	ソンザイ
存外	ゾンガイ
存生	ゾンジョウ
存知	ゾンチ
孝行	コウコウ
孟子	モウシ
孟宗	モウソウ
季節	キセツ
孤城落日	コジョウラクジツ
孤灯	コトウ
孤独	コドク
孤立	コリツ
学	ガク
学位	ガクイ
学力	ガクリョク
学友	ガクユウ
学名	ガクメイ
学問	ガクモン
学士	ガクシ
学年	ガクネン
学年末	ガクネンマツ
学才	ガクサイ
学期	ガッキ
学校	ガッコウ
学校教育	ガッコウキョウイク
学業	ガクギョウ
学理	ガクリ
学生	ガクセイ
学生時代	ガクセイジダイ
学生服	ガクセイフク
学界	ガッカイ
学科	ガッカ
学究	ガッキュウ
学者	ガクシャ
学説	ガクセツ
学課	ガッカ
学資	ガクシ
宅	タク
宅地	タクチ
宇宙	ウチュウ
宇治拾遺物語	ウジシュウイモノガタリ
守	モリ
守り	モリ
守宮	ヤモリ
安	ヤス
安らか	ヤスラカ
安井息軒	ヤスイソッケン
安価	アンカ
安全	アンゼン
安全ピン	アンゼンピン
安否	アンピ
安堵	アンド
安売り	ヤスウリ
安宅の関	アタカノセキ
安定	アンテイ
安心	アンシン
安楽	アンラク
安永	ヤスナガ
安田	ヤスダ
安直	アンチョク
安眠	アンミン
安置	アンチ
安臥	アンガ
安閑	アンカン
安静	アンセイ
完	カン
完全	カンゼン
完成	カンセイ
完璧	カンペキ
宗	ソウ
宗伯	ソウハク
宗教	シュウキョウ
宗教家	シュウキョウカ
宗旨	シュウシ
宗盛	ムネモリ
宗谷海峡	ソウヤカイキョウ
官位	カンイ
官吏	カンリ
官員	カンイン
官女	カンジョ
官立	カンリツ
官職	カンショク
官能	カンノウ
宙	チュウ
宙乗り	チュウノリ
宙返り	チュウガエリ
定	ジョウ
定石	ジョウセキ
定義	テイギ
定規	ジョウギ
定額	テイガク
宛	アテ
宛然	エンゼン
宝	タカラ
宝の持ち腐れ	タカラノモチグサレ
宝玉	ホウギョク
宝生流	ホウショウリュウ
宝石	ホウセキ
実	ミ
実えんどう	ミエンドウ
実しやか	マコトシヤカ
実は私は	ジツハワタシハ
実体	ジッタイ
実例	ジツレイ
実利	ジツリ
実名	ジツメイ
実在	ジツザイ
実地	ジッチ
実家	ジッカ
実年齢	ジツネンレイ
実情	ジツジョウ
実感	ジッカン
実業	ジツギョウ
実業家	ジツギョウカ
実業界	ジツギョウカイ
実状	ジツジョウ
実現	ジツゲン
実生活	ジッセイカツ
実用	ジツヨウ
実行	ジッコウ
実費	ジッピ
実質	ジッシツ
実際家	ジッサイカ
実際的	ジッサイテキ
実験	ジッケン
実験室	ジッケンシツ
客	キャク
客人	キャクジン
客扱い	キャクアツカイ
客来	キャクライ
客車	キャクシャ
客間	キャクマ
宣告	センコク
宣戦	センセン
室	シツ
室中	ムロナカ
室内	シツナイ
室戸	ムロト
宥恕	ユウジョ
宮	ミヤ
宮参り	ミヤマイリ
宮崎	ミヤザキ
宮廷	キュウテイ
宮殿	キュウデン
宮沢賢治	ミヤザワケンジ
宮芝居	ミヤシバイ
害	ガイ
宴	ウタゲ
宴会	エンカイ
宴席	エンセキ
宵	ヨイ
宵の口	ヨイノクチ
家	イエ
家々	イエイエ
家で	イエデ
家並	ヤナミ
家中	イエジュウ
家主	ヤヌシ
家事	カジ
家人	カジン
家具	カグ
家内	カナイ
家出	イエデ
家名	カメイ
家屋	カオク
家庭	カテイ
家庭教師	カテイキョウシ
家庭料理	カテイリョウリ
家族	カゾク
家来	ケライ
家根	ヤネ
家業	カギョウ
家老	カロウ
家賃	ヤチン
家路	イエジ
容	ヨウ
容体	ヨウダイ
容喙	ヨウカイ
容姿	ヨウシ
容子	ヨウス
容易	ヨウイ
容色	ヨウショク
容貌	ヨウボウ
容赦	ヨウシャ
容赦なく	ヨウシャナク
宿	ヤド
宿なし	ヤドナシ
宿り	ヤドリ
宿世	スクセ
宿命	シュクメイ
宿場	シュクバ
宿屋	ヤドヤ
宿料	シュクリョウ
宿替	ヤドガエ
宿泊	シュクハク
宿直	シュクチョク
寂	サビ
寂寞	セキバク
寂滅	ジャクメツ
寂然	ジャクネン
寄	ヤドリキ
寄せて	ヨセテ
寄せ鍋	ヨセナベ
寄り	ヨリ
寄り合	ヨリアイ
寄合	ヨリアイ
寄宿	キシュク
寄宿舎	キシュクシャ
寄寓	キグウ
寄席	ヨセ
寄木細工	ヨセギザイク
寄生虫	キセイチュウ
寄贈	キゾウ
寄附	キフ
寄附金	キフキン
密	ミツ
密売	ミツバイ
密封	ミップウ
密接	ミッセツ
密猟	ミツリョウ
密生	ミッセイ
密着	ミッチャク
密談	ミツダン
富	トミ
富坂	トミサカ
富士山	フジサン
富士見町	フジミチョウ
富子	トミコ
富時	トヨトキ
富浦	トミウラ
富貴	フウキ
寒	サム
寒き	カンキ
寒さ	サムサ
寒中	カンチュウ
寒天	カンテン
寒暖計	カンダンケイ
寒月	カンゲツ
寒村	カンソン
寒気	サムケ
寒竹	カンチク
寛	ヒロシ
寛大	カンダイ
寛容	カンヨウ
寝	ネ
寝ずの番	ネズノバン
寝ぼけ	ネボケ
寝冷	ネビエ
寝台	シンダイ
寝坊	ネボウ
寝室	シンシツ
寝小便	ネショウベン
寝巻	ネマキ
寝床	ネドコ
寝泊り	ネトマリ
寝物語	ネモノガタリ
寝覚	ネザメ
寝言	ネゴト
寝起き	ネオキ
寝返り	ネガエリ
寝顔	ネガオ
察	サッ
察し	サッシ
察度	サット
寡言	カゲン
寧	ヤスシ
審判	シンパン
審美	シンビ
審美眼	シンビガン
寮	リョウ
寮生活	リョウセイカツ
寶	タカラ
寸	スン
寸々	スンズン
寸分	スンブン
寸断	スンダン
寸法	スンポウ
寸評	スンピョウ
寺	テラ
寺内	テラウチ
寺参り	テラマイリ
寺院	ジイン
対	タイ
対句	ツイク
対坐	タイザ
対照	タイショウ
対立	タイリツ
対義語	タイギゴ
対話	タイワ
対語	タイゴ
対談	タイダン
対象	タイショウ
対象物	タイショウブツ
対蹠	タイショ
対面	タイメン
対馬海峡	ツシマカイキョウ
寿司	スシ
寿命	ジュミョウ
封	フウ
封かん	フウカン
封じ目	フウジメ
封建時代	ホウケンジダイ
封書	フウショ
封筒	フウトウ
専一	センイツ
専売	センバイ
専心	センシン
専攻	センコウ
専断	センダン
専有	センユウ
専門	センモン
専門的	センモンテキ
将	ハタ
将士	ショウシ
将官	ショウカン
将来	ショウライ
将校	ショウコウ
将棋	ショウギ
将棋盤	ショウギバン
将軍	ショウグン
将軍家	ショウグンケ
尊	ミコト
尊公	ソンコウ
尊敬	ソンケイ
尊敬の念	ソンケイノネン
尊顔	ソンガン
尋	ヒロ
尋問	ジンモン
尋常	ジンジョウ
導火線	ドウカセン
小	ショウ
小さい	チイサイ
小さな星	チイサナホシ
小人	コドモ
小作り	コヅクリ
小使	コヅカイ
小供	コドモ
小便	ショウベン
小倉	オグラ
小僧	コゾウ
小児	ショウニ
小刀	コガタナ
小切手	コギッテ
小判	コバン
小動物	ショウドウブツ
小勢	コゼイ
小包	コヅツミ
小千谷	オジヤ
小咄	コバナシ
小坊主	コボウズ
小声	コゴエ
小学校	ショウガッコウ
小屋	コヤ
小川町	オガワマチ
小形	コガタ
小指	コユビ
小文字	コモジ
小日向	オビナタ
小春	コハル
小書き	コガキ
小木	オギ
小本	コモト
小松菜	コマツナ
小柄	コガラ
小桶	コオケ
小梅	コウメ
小母	オバ
小泉八雲	コイズミヤクモ
小湊	コミナト
小為替	コガワセ
小牛	コウジ
小犬	コイヌ
小理屈	コリクツ
小生	ショウセイ
小生意気	コナマイキ
小用	ショウヨウ
小男	コオトコ
小町	コマチ
小癪	コシャク
小皿	コザラ
小督	コゴウ
小石	コイシ
小石川	コイシカワ
小笠原流	オガサワラリュウ
小箱	コバコ
小脇	コワキ
小舟	コブネ
小菊	コギク
小言	コゴト
小説	ショウセツ
小説家	ショウセツカ
小路	コウジ
小遣	コヅカイ
小遣い	コヅカイ
小鈴	コスズ
小鉢	コバチ
小間使	コマヅカイ
小間物	コマモノ
小額	ショウガク
小食	ショウショク
小魚	コウオ
小鳥	コトリ
小鼻	コバナ
少女	ショウジョ
少年	ショウネン
少年雑誌	ショウネンザッシ
少時	ショウジ
少量	ショウリョウ
尨	ムクイヌ
就	ツク
尺	シャク
尺寸	シャクスン
尻	シリ
尻尾	シッポ
尻込み	シリゴミ
尻餅	シリモチ
尼	アマ
尽力	ジンリョク
尽未来際	ジンミライサイ
尾	オ
尾張町	オワリチョウ
尾行	ビコウ
尿	ニョウ
尿毒症	ニョウドクショウ
局	ツボネ
局外者	キョクガイシャ
局所	キョクショ
局部	キョクブ
局長	キョクチョウ
局面	キョクメン
屁	ヘ
居	キョ
居ずまい	イズマイ
居住地	キョジュウチ
居候	イソウロウ
居合抜	イアイヌキ
居士	コジ
居宅	キョタク
居心地	イゴコチ
居直り強盗	イナオリゴウトウ
居眠り	イネムリ
居間	イマ
屈	クツ
屈伏	クップク
屈原	クツゲン
屈従	クツジュウ
屈曲	クッキョク
屈辱	クツジョク
届	トドケ
届で	トドケデ
屋	ヤ
屋上	オクジョウ
屋台	ヤタイ
屋号	ヤゴウ
屋島	ヤシマ
屋敷	ヤシキ
屋敷町	ヤシキチョウヤシキマチ
屋根	ヤネ
屋根の上に	ヤネノウエニ
屑	クズ
展望	テンボウ
展覧	テンラン
展覧会	テンランカイ
展開	テンカイ
属	ゾク
層	ソウ
履歴	リレキ
履歴書	リレキショ
履行	リコウ
山	ヤマ
山々	ヤマヤマ
山の上	ヤマノウエ
山の芋	ヤマノイモ
山上	サンジョウ
山下	ヤマシタ
山伏	ヤマブシ
山出し	ヤマダシ
山口県山陽小野田市厚狭	ヤマグチケンサンヨウオノダシアサ
山吹	ヤマブキ
山地	サンチ
山城屋	ヤマシロヤ
山姥	ヤマウバ
山寺	ヤマデラ
山嵐	ヤマアラシ
山川	ヤマカワ
山師	ヤマシ
山形県	ヤマガタケン
山桃	ヤマモモ
山桜	ヤマザクラ
山椒	サンショウ
山河	サンガ
山盛	ヤマモリ
山盛り	ヤマモリ
山羊	ヤギ
山芋	ヤマイモ
山茶花	サザンカ
山菜	サンサイ
山葵	ワサビ
山賊	サンゾク
山道	サンドウ
山門	サンモン
山間部	サンカンブ
山陽	サンヨウ
山高帽	ヤマタカボウ
山高帽子	ヤマタカボウシ
屹立	キツリツ
岡	オカ
岡っ引き	オカッピキ
岡山	オカヤマ
岡本帰一	オカモトキイチ
岩	イワ
岩の上	イワノウエ
岩塩	ガンエン
岩崎	イワサキ
岩手県平泉町	イワテケンヒライズミチョウ
岩桃	イワモモ
岩波書店	イワナミショテン
岩見	イワミ
岫	クキ
岸	キシ
岸辺	キシベ
峙	ソワ
峠	トウゲ
峡谷	キョウコク
峯	ミネ
峰子	ミネコ
島	シマ
島田	シマダ
峻	タカシ
峻嶮	シュンケン
崇高	スウコウ
崎	サキ
崖	ガケ
崩し	クズシ
崩れ	クズレ
崩壊	ホウカイ
崩御	ホウギョ
嵐	アラシ
嵩	カサ
巌	イワオ
川	カワ
川はば	カワハバ
川上	カワカミ
川下	カワシモ
川原	カワハラ
川村	カワムラ
川添	カワゾエ
川端	カワバタ
州	シュウ
巡り	メグリ
巡回	ジュンカイ
巡査	ジュンサ
巣鴨	スガモ
工	コウ
工事	コウジ
工兵	コウヘイ
工合	グアイ
工夫	クフウ
工廠	コウショウ
工芸	コウゲイ
工面	クメン
左	ヒダリ
左側	ヒダリガワ
左側に	ヒダリガワニ
左右	サユウ
左向	サコウ
左手	ヒダリテ
左氏	サシ
左甚五郎	ヒダリジンゴロウ
左翼	サヨク
左舷	サゲン
左記	サキ
巧	タクミ
巧み	タクミ
巧妙	コウミョウ
巧者	コウシャ
巨	ナオ
巨人	キョジン
巨匠	キョショウ
巨峰	キョホウ
差	サ
差し	サシ
差し入れ	サシイレ
差出人	サシダシニン
差別	サベツ
差向い	サシムカイ
差支	サシツカエ
差支え	サシツカエ
差異	サイ
差違	サイ
己	オノレ
巴理	トモリ
巴里	ハリ
巻	マキ
巻き	マキ
巻き寿司	マキズシ
巻煙草	マキタバコ
巻紙	マキガミ
巻頭	カントウ
巾	ハバ
巾着	キンチャク
巾着切	キンチャクキリ
市	シ
市ヶ谷	イチガヤ
市中	シチュウ
市内	シナイ
市区改正	シクカイセイ
市場	シジョウ
市民	シミン
市電	シデン
布	ヌノ
布令	フレイ
布哇	ハワイ
布団	フトン
布巾	フキン
帆	ホ
希	マレ
希少価値	キショウカチ
希望	キボウ
帖	ジョウ
帝	ミカド
帝国	テイコク
帝国ホテル	テイコクホテル
帝都	テイト
帥	ソチ
師	シ
師匠	シショウ
師弟	シテイ
師範	シハン
師範学校	シハンガッコウ
師表	シヒョウ
師走	シワス
師道	シドウ
席	セキ
席上	セキジョウ
席末	セキマツ
席順	セキジュン
帯	オビ
帰	キ
帰り	カエリ
帰りがけ	カエリガケ
帰り道	カエリミチ
帰り際	カエリギワ
帰京	キキョウ
帰依	キエ
帰国	キコク
帰天	キテン
帰宅	キタク
帰省	キセイ
帰着	キチャク
帰臥	キガ
帰路	キロ
帳	トバリ
帳場	チョウバ
帳面	チョウメン
常	ツネ
常人	ジョウジン
常態	ジョウタイ
常磐	トキワ
常規	ツネノリ
常識	ジョウシキ
常連	ジョウレン
常道	ジョウドウ
帽	ボウ
帽子	ボウシ
帽子屋	ボウシヤ
幅	ハバ
幕	マク
幣	ヌサ
干潮	カンチョウ
干物	ホシモノ
干瓢	カンピョウ
平	タイラ
平々	ヒラダイラ
平たい	ヒラタイ
平ら	タイラ
平仮名	ヒラガナ
平凡	ヘイボン
平助	ヘイスケ
平和	ヘイワ
平地	ヒラチ
平均	ヘイキン
平坦	ヘイタン
平安時代	ヘイアンジダイ
平安朝	ヘイアンチョウ
平家	ヒラカ
平屋	ヒラヤ
平山誠	ヒラヤママコト
平常	ヘイジョウ
平成	ヘイセイ
平手	ヒラテ
平時	ヘイジ
平板	ヘイバン
平氏	タイラウジ
平気	ヘイキ
平治の乱	ヘイジノラン
平泉	ヒライズミ
平生	ヘイゼイ
平穏	ヘイオン
平等	ビョウドウ
平素	ヘイソ
平行	ヘイコウ
平身低頭	ヘイシンテイトウ
平連	ヒラレン
平静	ヘイセイ
平面	ヘイメン
年	トシ
年々	ネンネン
年の功	トシノコウ
年の暮	トシノクレ
年上	トシウエ
年中	ネンジュウ
年始	ネンシ
年寄	トシヨリ
年寄り	トシヨリ
年嵩	トシカサ
年廻り	トシマワリ
年数	ネンスウ
年月	トシツキ
年来	ネンライ
年格好	トシカッコウ
年歯	ネンシ
年生	トシセイ
年賀	ネンガ
年輩	ネンパイ
年長者	ネンチョウシャ
年間	ネンカン
年頃	トシゴロ
年齢	ネンレイ
幸	コウ
幸い	サイワイ
幸水	コウスイ
幸福	コウフク
幸運	コウウン
幹	ミキ
幹事	カンジ
幹二	カンジ
幻	マボロシ
幻影	ゲンエイ
幻想	ゲンソウ
幻燈	ゲントウ
幻聴	ゲンチョウ
幼	ヨウ
幼児	ヨウジ
幼名	ヨウメイ
幼子	オサナゴ
幼少	ヨウショウ
幼年時代	ヨウネンジダイ
幼稚	ヨウチ
幼稚園	ヨウチエン
幼虫	ヨウチュウ
幽か	カスカ
幽冥	ユウメイ
幽谷	ユウコク
幽邃	ユウスイ
幽閉	ユウヘイ
幽霊	ユウレイ
幾	イク
幾つ	イクツ
幾万	イクマ
幾世	イクヨ
幾何	キカ
幾何学	キカガク
幾分	イクブン
幾多	イクタ
幾度	イクド
幾日	イクニチ
幾本	イクモト
庁	チョウ
広め	ヒロメ
広告	コウコク
広場	ヒロバ
広島	ヒロシマ
広葉樹	コウヨウジュ
広通	ヒロミチ
広間	ヒロマ
庄屋	ショウヤ
庇	ヒサシ
庇護	ヒゴ
床	ユカ
床の間	トコノマ
床几	ショウギ
床屋	トコヤ
床板	トコイタ
床柱	トコバシラ
序幕	ジョマク
序開き	ジョビラキ
底	ソコ
底冷え	ソコビエ
底本	テイホン
店	ミセ
店先	ミセサキ
店内	テンナイ
店頭	テントウ
庚申山	コウシンヤマ
府	フ
度	ド
度合	ドアイ
度外	ドガイ
度数	ドスウ
度盛	ドモリ
度目	ドメ
度胸	ドキョウ
座	ザ
座布団	ザブトン
座席	ザセキ
座敷	ザシキ
座禅	ザゼン
座興	ザキョウ
座蒲団	ザブトン
庫	クラ
庭	ニワ
庭下駄	ニワゲタ
庭中	テイチュウ
庭先	ニワサキ
庭前	テイゼン
庭口	ニワグチ
庭園	テイエン
庭木	ニワキ
庭梅	ニワウメ
庵	アン
庸	イサオ
廂	ヒサシ
廃	ハイ
廃業	ハイギョウ
廃絶	ハイゼツ
廊下	ロウカ
廓清	カクセイ
廓然無聖	カクネンムショウ
廬	イオリ
延命息災	エンメイソクサイ
延岡	ノベオカ
建	ケン
建仁寺	ケンニンジ
建具	タテグ
建武	ケンム
建物	タテモノ
建築	ケンチク
廻	マワリ
廻し	マワシ
廻り	マワリ
廻り合せ	メグリアワセ
廻転	カイテン
廿	ニジュウ
弁償	ベンショウ
弁口	ベンコウ
弁当	ベントウ
弁当箱	ベントウバコ
弁慶	ベンケイ
弁明	ベンメイ
弁舌	ベンゼツ
弁解	ベンカイ
弁論	ベンロン
弁護	ベンゴ
弁難	ベンナン
弄	ロウ
弊	ヘイ
弊竇	ヘイトウ
弊風	ヘイフウ
式	シキ
式場	シキジョウ
式部	シキブ
弓	ユミ
弓矢	ユミヤ
弔詞	チョウシ
引	ヒキ
引き	ヒキ
引きうけ	ヒキウケ
引き出し	ヒキダシ
引き合	ヒキアイ
引き渡し	ヒキワタシ
引け	ヒケ
引上げ	ヒキアゲ
引出し	ヒキダシ
引力	インリョク
引取り手	ヒキトリテ
引受	ヒキウケ
引合	ヒキアイ
引合い	ヒキアイ
引掛	ヒッカカリ
引率	インソツ
引用	インヨウ
引窓	ヒキマド
引越し	ヒッコシ
弘法大師	コウボウダイシ
弛み	ユルミ
弟	オトウト
弥	ワタル
弥生	ヤヨイ
弧線	コセン
弩	イシユミ
弱	ジャク
弱り目に祟り目	ヨワリメニタタリメ
弱点	ジャクテン
弱虫	ヨワムシ
張	チョウ
張り	ハリ
張付け	ハリツケ
張合	ハリアイ
張合い	ハリアイ
張本	チョウホン
張番	ハリバン
張飛	チョウヒ
強	ツヨ
強い力	ツヨイチカラ
強力	キョウリョク
強勢	キョウセイ
強弩	キョウド
強情	ゴウジョウ
強烈	キョウレツ
強盗	ゴウトウ
強精剤	キョウセイザイ
強者	ツワモノ
強談	ゴウダン
弾	タマ
弾丸	ダンガン
弾力	ダンリョク
弾力性	ダンリョクセイ
弾道	ダンドウ
当	トウ
当て	アテ
当り	アタリ
当り前	アタリマエ
当り障り	アタリサワリ
当世	トウセイ
当主	トウシュ
当人	トウニン
当分	トウブン
当初	トウショ
当前	トウマエ
当地	トウチ
当夜	トウヤ
当家	トウケ
当局者	トウキョクシャ
当年	トウネン
当座	トウザ
当惑	トウワク
当日	トウジツ
当時	トウジ
当番	トウバン
当直	トウチョク
当該	トウガイ
当面	トウメン
彗星	スイセイ
形	カタチ
形体	ケイタイ
形勝	ケイショウ
形勢	ケイセイ
形容	ケイヨウ
形容詞	ケイヨウシ
形式	ケイシキ
形式的	ケイシキテキ
形式論理学	ケイシキロンリガク
形而下	ケイジカ
形跡	ケイセキ
形骸	ケイガイ
彩色	サイシキ
彫り	ホリ
彫刻	チョウコク
影	カゲ
影ぼうし	カゲボウシ
影像	エイゾウ
影法師	カゲボウシ
影裏	エイリ
影響	エイキョウ
彷徨	ホウコウ
役	ヤク
役人	ヤクニン
役割	ヤクワリ
役員	ヤクイン
役所	ヤクショ
役目	ヤクメ
役者	ヤクシャ
彼	カレ
彼ら	カレラ
彼女	カノジョ
彼岸	ヒガン
彼岸桜	ヒガンザクラ
彼岸花	ヒガンバナ
彼等	カレラ
彼自身	カレジシン
往き	ユキ
往き来	ユキキ
往復	オウフク
往昔	オウセキ
往来	オウライ
往生	オウジョウ
征伐	セイバツ
征露	セイロ
径路	ケイロ
待	マチ
待ち	マチ
待ち伏せ	マチブセ
待った	マッタ
待合	マチアイ
待遇	タイグウ
律	リツ
律師	リッシ
後	ノチ
後いつ	コウイツ
後なん	コウナン
後れ	オクレ
後ろ	ウシロ
後ろ向	ウシロムキ
後ろ向き	ウシロムキ
後世	コウセイ
後任	コウニン
後光	ゴコウ
後列	コウレツ
後半	コウハン
後天性	コウテンセイ
後始末	アトシマツ
後姿	ウシロスガタ
後学	コウガク
後年	コウネン
後廻し	アトマワシ
後悔	コウカイ
後戻り	アトモドリ
後方	コウホウ
後日	ゴジツ
後日談	ゴジツダン
後来	コウライ
後架	コウカ
後生	ゴショウ
後生大事	ゴショウダイジ
後者	コウシャ
後裔	コウエイ
後足	アトアシ
後述	コウジュツ
後進	コウシン
後部	コウブ
後鉢巻	ウシロハチマキ
徐々	ジョジョ
徒	ト
徒刑	トケイ
徒労	トロウ
徒町	オカチマチ
従事	ジュウジ
従前	ジュウゼン
従卒	ジュウソツ
従妹	ジュウマイ
従姉妹	イトコ
従容	ショウヨウ
従者	ジュウシャ
得	トク
得々	トクトク
得たい	エタイ
得て	エテ
得体	エタイ
得富	トクトミ
得心	トクシン
得意	トクイ
得意気	トクイゲ
得手	エテ
得策	トクサク
徘徊	ハイカイ
御上	オカミ
御両人	ゴリョウニン
御主人	ミウシ
御代	ミヨ
御会式	オエシキ
御作	ミツクリ
御免	ゴメン
御免なさい	ゴメンナサイ
御利益	ゴリヤク
御前	ゴゼン
御召	オメシ
御台	ミダイ
御名	ギョメイ
御国	オクニ
御大	オンタイ
御存じ	ゴゾンジ
御存知	ゴゾンジ
御客	オキャク
御客さま	オキャクサマ
御客さん	オキャクサン
御宮	オミヤ
御寺	ミテラ
御屋敷	オヤシキ
御山	オヤマ
御座	ギョザ
御座候	ゴザソウロウ
御影	ミカゲ
御影石	ミカゲイシ
御待遠さま	オマチドオサマ
御念	ゴネン
御意	ギョイ
御意向	ゴイコウ
御慶	ギョケイ
御機嫌	ゴキゲン
御歳暮	オセイボ
御殿	ゴテン
御気の毒様	オキノドクサマ
御法度	ゴハット
御用	ゴヨウ
御用達	ゴヨウタツ
御盆	オボン
御石	ミセキ
御礼	オレイ
御神体	ゴシンタイ
御膳	ゴゼン
御苦労	ゴクロウ
御茶の水	オチャノミズ
御蔭	オカゲ
御蔭様	オカゲサマ
御覧	ゴラン
御託宣	ゴタクセン
御足労	ゴソクロウ
御身	オンミ
御酒	ミキ
御釜	オカマ
御門	ミカド
御難	ゴナン
御願	ゴガン
御飯	ゴハン
御饌	ミケ
御馳走	ゴチソウ
復命	フクメイ
復活	フッカツ
復籍	フクセキ
復興	フッコウ
復讐	フクシュウ
循	メグル
循環	ジュンカン
微か	カスカ
微光	ビコウ
微動	ビドウ
微塵	ミジン
微妙	ビミョウ
微弱	ビジャク
微笑	ビショウ
微細	ビサイ
微衷	ビチュウ
微醺	ビクン
徳	トク
徳利	トックリ
徳化	トッカ
徳島県	トクシマケン
徳義心	トクギシン
徴	シルシ
徴候	チョウコウ
徴集	チョウシュウ
徹夜	テツヤ
徹底	テッテイ
徹底的	テッテイテキ
徹骨徹髄	テッコツテツズイ
徽章	キショウ
心	ココロ
心づかい	ココロヅカイ
心もち	ココロモチ
心丈夫	ココロジョウブ
心中	シンジュウ
心中物	シンジュウモノ
心労	シンロウ
心地	ココチ
心境	シンキョウ
心太	トコロテン
心当り	ココロアタリ
心待ち	ココロマチ
心得	ココロエ
心得違い	ココロエチガイ
心得顔	ココロエガオ
心意	シンイ
心持	ココロモチ
心持ち	ココロモチ
心掛け	ココロガケ
心棒	シンボウ
心構え	ココロガマエ
心機	シンキ
心残り	ココロノコリ
心理	シンリ
心理的	シンリテキ
心痛	シンツウ
心的	シンテキ
心眼	シンガン
心神	シンシン
心算	シンサン
心細さ	ココロボソサ
心置	ココロオキ
心置き	ココロオキ
心臓	シンゾウ
心遣い	ココロヅカイ
心配	シンパイ
必定	ヒツジョウ
必死	ヒッシ
必然	ヒツゼン
必用	ヒツヨウ
必要	ヒツヨウ
忍	ニン
忍び	シノビ
忍びやか	シノビヤカ
忍び足	シノビアシ
忍耐	ニンタイ
志	ココロザシ
志乃	シノ
志望	シボウ
志願兵	シガンヘイ
忘れ	ワスレ
忘却	ボウキャク
忘年会	ボウネンカイ
忙中	ボウチュウ
応え	コタエ
応対	オウタイ
応戦	オウセン
応用	オウヨウ
忠勇義烈	チュウユウギレツ
忠告	チュウコク
忠実	チュウジツ
忠恕	タダヒロ
忠臣蔵	チュウシングラ
快事	カイジ
快哉	カイサイ
快楽	カイラク
快活	カイカツ
快走	カイソウ
念	ネン
念入	ネンイリ
念入り	ネンイリ
念頭	ネントウ
怒り	イカリ
怒りの声	イカリノコエ
怒り方	オコリカタ
怒号	ドゴウ
怒声	ドセイ
怒気	ドキ
怜悧	レイリ
怜悧狡猾	レイリコウカツ
思	オモイ
思い	オモイ
思いつき	オモイツキ
思いのほか	オモイノホカ
思いやり	オモイヤリ
思い付き	オモイツキ
思い入れ	オモイイレ
思い出	オモイデ
思い切り	オモイキリ
思い違い	オモイチガイ
思召し	オボシメシ
思惑	オモワク
思惟	シイ
思想	シソウ
思想家	シソウカ
思慮	シリョ
思案	シアン
思潮	シチョウ
思索	シサク
思考	シコウ
怠惰	タイダ
怠慢	タイマン
急	キュウ
急ぎ足	イソギアシ
急場	キュウバ
急変	キュウヘン
急所	キュウショ
急用	キュウヨウ
急病	キュウビョウ
急転	キュウテン
性	セイ
性分	ショウブン
性急	セイキュウ
性悪	セイアク
性情	セイジョウ
性慾	セイヨク
性格	セイカク
性欲	セイヨク
性癖	セイヘキ
性行	セイコウ
性質	セイシツ
怨恨	エンコン
怨言	エンゲン
怪	カイ
怪奇	カイキ
怪我	ケガ
怪物	カイブツ
怪訝	ケゲン
怪談	カイダン
怫然	フツゼン
恋	コイ
恋をする	コイヲスル
恋人	コイビト
恋愛	レンアイ
恋慕	レンボ
恋煩い	コイワズライ
恋着	レンチャク
恍惚	コウコツ
恐く	キョウク
恐れ	オソレ
恐怖	キョウフ
恐怖感	キョウフカン
恐悦	キョウエツ
恐縮	キョウシュク
恕	ジョ
恥	ハジ
恥の上塗り	ハジノウワヌリ
恥知らず	ハジシラズ
恥辱	チジョク
恨	コン
恨み	ウラミ
恨事	コンジ
恩	オン
恩人	オンジン
恩借	オンシャク
恩返	オンガエシ
恩顧	オンコ
恬然	テンゼン
恭謙	キョウケン
恭賀新年	キョウガシンネン
息	イキ
息女	ソクジョ
息子	ムスコ
息遣い	イキヅカイ
恰好	カッコウ
恵	メグミ
恵比寿	エビス
悄々	ショウショウ
悄然	ショウゼン
悔恨	カイコン
悖徳没倫	ハイトクボツリン
悟	サトル
悟り	サトリ
悟道	ゴドウ
悠々	ユウユウ
悠々閑々	ユウユウカンカン
悠長	ユウチョウ
患者	カンジャ
悦	エツ
悩乱	ノウラン
悪	ワル
悪い	ワルイ
悪いこと	ワルイコト
悪い男	ワルイオトコ
悪さ	ワルサ
悪もの	ワルモノ
悪事	アクジ
悪事千里	アクジセンリ
悪人	アクニン
悪僧	アクソウ
悪党	アクトウ
悪友	アクユウ
悪口	ワルグチ
悪太郎	アクタロウ
悪寒	オカン
悪徳者	アクトクシャ
悪意	アクイ
悪戯	イタズラ
悪漢	アッカン
悪辣	アクラツ
悪風	アクフウ
悪魔	アクマ
悲しみ	カナシミ
悲劇	ヒゲキ
悲哀	ヒアイ
悲境	ヒキョウ
悲壮	ヒソウ
悲惨	ヒサン
悲痛	ヒツウ
悲運	ヒウン
悲酸	ヒサン
悲鳴	ヒメイ
悵然	チョウゼン
情	ジョウ
情け	ナサケ
情勢	ジョウセイ
情合	ジョウアイ
情報	ジョウホウ
情夫	ジョウフ
情実	ジョウジツ
情慾	ジョウヨク
情操	ジョウソウ
情死	ジョウシ
情熱	ジョウネツ
情調	ジョウチョウ
惰性	ダセイ
想い出	オモイデ
想像	ソウゾウ
想見	ソウケン
愁え	ウレエ
愁然	シュウゼン
愉快	ユカイ
意	イ
意中	イチュウ
意中の人	イチュウノヒト
意向	イコウ
意味	イミ
意嚮	イコウ
意地	イジ
意地張り	イジッパリ
意地悪	イジワル
意外	イガイ
意志	イシ
意志の力	イシノチカラ
意思	イシ
意気	イキ
意気地	イクジ
意気地なし	イクジナシ
意気組	イキグミ
意気込	イキゴミ
意気込み	イキゴミ
意義	イギ
意見	イケン
意識	イシキ
意趣返し	イシュガエシ
愕然	ガクゼン
愚	グ
愚か	オロカ
愚かもの	オロカモノ
愚人	グジン
愚劣	グレツ
愚図	グズ
愚妻	グサイ
愚弄	グロウ
愚昧	グマイ
愚物	グブツ
愚痴	グチ
愚策	グサク
愚考	グコウ
愚見	グケン
愛	アイ
愛がなければ	アイガナケレバ
愛人	アイジン
愛国心	アイコクシン
愛好家	アイコウカ
愛媛	エヒメ
愛嬌	アイキョウ
愛情	アイジョウ
愛想	アイソ
愛撫	アイブ
愛読	アイドク
愛顧	アイコ
愛馬	アイバ
感	カン
感じ	カンジ
感傷	カンショウ
感傷的	カンショウテキ
感動	カンドウ
感化	カンカ
感嘆	カンタン
感得	カントク
感心	カンシン
感応	カンオウ
感情	カンジョウ
感想	カンソウ
感慨	カンガイ
感懐	カンカイ
感服	カンプク
感染	カンセン
感激	カンゲキ
感熱紙	カンネツシ
感興	カンキョウ
感覚	カンカク
感謝	カンシャ
感銘	カンメイ
慄然	リツゼン
慇懃	インギン
慈善	ジゼン
慈善会	ジゼンカイ
慈悲	ジヒ
慈雨	ジウ
態	タイ
態度	タイド
慎み	ツツシミ
慎重	シンチョウ
慚愧	ザンキ
慢心	マンシン
慢性	マンセイ
慢性結膜炎	マンセイケツマクエン
慣例	カンレイ
慣用	カンヨウ
慥か	タシカ
慰み	ナグサミ
慰安	イアン
慰撫	イブ
慰藉	イシャ
慶賀	ケイガ
慾	ヨク
憂	ウ
憂目	ウキメ
憂身	ウキミ
憂鬱	ユウウツ
憎しみ	ニクシミ
憎悪	ゾウオ
憐	レン
憐れ	アワレ
憚り	ハバカリ
憚り様	ハバカリサマ
憤慨	フンガイ
憤然	フンゼン
憧憬	ドウケイ
憫然	ビンゼン
憫笑	ビンショウ
憮然	ブゼン
憲法	ケンポウ
憶	オク
懇切	コンセツ
懇意	コンイ
懇願	コンガン
懊悩	オウノウ
懐	フトコロ
懐中	カイチュウ
懐剣	カイケン
懐妊	カイニン
懐手	フトコロデ
懐旧	カイキュウ
懲り懲り	コリゴリ
懲役	チョウエキ
懸命	ケンメイ
懸崖	ケンガイ
懸念	ケネン
懸賞	ケンショウ
懸隔	ケンカク
懺悔	ザンゲ
戈	ホコ
成	シゲル
成人	セイジン
成仏	ジョウブツ
成元	ナリモト
成功	セイコウ
成句	セイク
成就	ジョウジュ
成敗	セイバイ
成立	セイリツ
成算	セイサン
成績	セイセキ
成行	シゲユキ
成行き	ナリユキ
成規	シゲノリ
成語	セイゴ
成道	ジョウドウ
成長	セイチョウ
成雄	シゲオ
我	ガ
我々	ワレワレ
我ら	ワレラ
我儘	ワガママ
我勝ち	ワレガチ
我意	ガイ
我慢	ガマン
我流	ガリュウ
我無	ガム
我物顔	ワガモノガオ
戒名	カイミョウ
或人	アルト
戦	セン
戦い	タタカイ
戦争	センソウ
戦勝国	センショウコク
戦場	センジョウ
戦役	センエキ
戦慄	センリツ
戦死	センシ
戦闘	セントウ
截然	セツゼン
戯曲家	ギキョクカ
戸	ト
戸前	トマエ
戸口	トグチ
戸外	コガイ
戸惑い	トマドイ
戸棚	トダナ
戸締	トジマリ
戸締り	トジマリ
戸袋	トブクロ
戻り	モドリ
房	ボウ
房子	フサコ
房州	ボウシュウ
房酸塊	フサスグリ
所	トコロ
所々	トコロドコロ
所以	ユエン
所作	ショサ
所在地	ショザイチ
所得	ショトク
所有	ショユウ
所有権	ショユウケン
所有者	ショユウシャ
所望	ショモウ
所為	ショイ
所番地	トコロバンチ
所謂	イワユル
扇	オウギ
扇子	センス
扉	トビラ
扉をあけて	トビラヲアケテ
手	テ
手つき	テツキ
手のひら	テノヒラ
手の平	テノヒラ
手の甲	テノコウ
手下	テシタ
手並	テナミ
手中	シュチュウ
手付	テツケ
手伝	テツダイ
手伝い	テツダイ
手元	テモト
手先	テサキ
手出し	テダシ
手分け	テワケ
手初め	テハジメ
手前	テマエ
手合	テアイ
手向け	タムケ
手品	テジナ
手始め	テハジメ
手巻き寿司	テマキズシ
手巾	シュキン
手帖	テチョウ
手帳	テチョウ
手廻し	テマワシ
手当	テアテ
手心	テゴコロ
手応	テゴタエ
手応え	テゴタエ
手懸り	テガカリ
手招	テマネキ
手拭	テヌグイ
手持無沙汰	テモチブサタ
手掛り	テガカリ
手放し	テバナシ
手数	テスウ
手本	テホン
手枕	テマクラ
手柄	テガラ
手桶	テオケ
手段	シュダン
手水鉢	チョウズバチ
手法	シュホウ
手渡し	テワタシ
手燭	シュショク
手癖	テクセ
手真似	テマネ
手答	テゴタエ
手紙	テガミ
手続	テツヅキ
手続き	テツヅキ
手織	テオリ
手織り	テオリ
手腕	シュワン
手荒	テアラ
手落	テオチ
手落ち	テオチ
手蔓	テヅル
手製	テセイ
手記	シュキ
手詰	テヅメ
手足	テアシ
手蹟	シュセキ
手車	テグルマ
手軽	テガル
手近	テヂカ
手違い	テチガイ
手配	テハイ
手錠	テジョウ
手際	テギワ
手離	テバナレ
手頃	テゴロ
手首	テクビ
手馴	テナラシ
才	サイ
才人	サイジン
才子	サイシ
才気	サイキ
才能	サイノウ
才芸	サイゲイ
打	ダ
打ち	ウチ
打ち壊	ウチコワシ
打て	ウツテ
打倒	ダトウ
打出の小槌	ウチデノコヅチ
打吹山	ウツブキヤマ
打撃	ダゲキ
打擲	チョウチャク
打算	ダサン
払い	ハライ
払底	フッテイ
払込	ハライコミ
托	タク
扱い	アツカイ
批判	ヒハン
批評	ヒヒョウ
批評家	ヒヒョウカ
承知	ショウチ
承認	ショウニン
承諾	ショウダク
技	ワザ
技巧	ギコウ
技手	ギシュ
技芸	ギゲイ
技術	ギジュツ
把	ワ
抑え	オサエ
投	トウ
投函	トウカン
投書	トウショ
抗議	コウギ
折	オリ
折々	オリオリ
折りたたみ	オリタタミ
折り紙	オリガミ
折助	オリスケ
折合	オレアイ
折戸	オリド
折角	セッカク
抜き	ヌキ
抜け毛	ヌケゲ
抜け裏	ヌケウラ
抜手	ヌキテ
抜身	ヌキミ
択	タク
披瀝	ヒレキ
披露	ヒロウ
抱え	カカエ
抱負	ホウフ
抵抗	テイコウ
抹殺	マッサツ
抹茶	マッチャ
押し	オシ
押しピン	オシピン
押し売り	オシウリ
押し葉	オシバ
押入	オシイレ
押入れ	オシイレ
押問答	オシモンドウ
抽出	チュウシュツ
抽斗	ヒキダシ
抽象	チュウショウ
担々麺	タンタンメン
担任	タンニン
拇指	ボシ
拍	ハク
拍子	ヒョウシ
拍子抜け	ヒョウシヌケ
拍子木	ヒョウシギ
拍手	ハクシュ
拒否	キョヒ
拒絶	キョゼツ
拘泥	コウデイ
招待	ショウタイ
招魂	ショウコン
招魂社	ショウコンシャ
拝	ハイ
拝借	ハイシャク
拝啓	ハイケイ
拝聴	ハイチョウ
拝見	ハイケン
拝趨	ハイスウ
拝顔	ハイガン
拠	ヨリドコロ
拡張	カクチョウ
括り枕	ククリマクラ
拮抗	キッコウ
拱手	コウシュ
拳	コブシ
拳骨	ゲンコツ
拵	コシラエ
拵え事	コシラエゴト
拷問	ゴウモン
拾	ジツ
拾い読み	ヒロイヨミ
持	ジ
持ち主	モチヌシ
持ち前	モチマエ
持ち物	モチモノ
持主	モチヌシ
持前	モチマエ
持参	ジサン
持参金	ジサンキン
持物	モチモノ
持病	ジビョウ
持続	ジゾク
持説	ジセツ
持駒	モチゴマ
指	ユビ
指先	ユビサキ
指名	シメイ
指図	サシズ
指定	シテイ
指導	シドウ
指導原理	シドウゲンリ
指揮	シキ
指揮者	シキシャ
指摘	シテキ
指数	シスウ
指環	ユビワ
指金	サシガネ
指針	シシン
指頭	シトウ
按排	アンバイ
按摩	アンマ
按腹	アンプク
挑撥	チョウハツ
挙	キョ
挙動	キョドウ
挙止動作	キョシドウサ
挙行	キョコウ
挨拶	アイサツ
振り	フリ
振子	フリコ
振舞	フルマイ
振袖	フリソデ
挺	テイ
挽回	バンカイ
挿入	ソウニュウ
捏造	ネツゾウ
捕捉	ホソク
捕獲	ホカク
捕縛	ホバク
捕虜	ホリョ
据	シガラミ
捺	ナツ
捺印	ナツイン
捻り	ヒネリ
掃溜	ハキダメ
掃蕩	ソウトウ
掃除	ソウジ
授業	ジュギョウ
掌	テノヒラ
掏摸	スリ
排列	ハイレツ
排斥運動	ハイセキウンドウ
排泄	ハイセツ
掛	カケ
掛け	カケ
掛けず	カケズ
掛り	カカリ
掛ケ	カケ
掛ケ合	カケアイ
掛合	カケアイ
掛声	カケゴエ
掛物	カケモノ
掛矢	カケヤ
掛算	カケザン
掛茶屋	カケヂャヤ
掛蒲団	カケブトン
掛金	カケキン
掠奪	リャクダツ
探偵	タンテイ
探偵小説	タンテイショウセツ
探検	タンケン
探知	タンチ
探索	タンサク
探険	タンケン
接待	セッタイ
接触	セッショク
接近	セッキン
控	ヒカエ
控え	ヒカエ
控室	ヒカエシツ
推して知るべし	オシテシルベシ
推参	スイサン
推定	スイテイ
推察	スイサツ
推断	スイダン
推測	スイソク
推知	スイチ
推移	スイイ
推計	スイケイ
推論	スイロン
掲示板	ケイジバン
掲載	ケイサイ
揃	ソロイ
揃い	ソロイ
揉療治	モミリョウジ
描写	ビョウシャ
提供	テイキョウ
提出	テイシュツ
提案	テイアン
提灯	チョウチン
提琴	テイキン
揚げ	アゲ
揚句	アゲク
揚板	アゲイタ
揚足	アゲアシ
換言	カンゲン
握り拳	ニギリコブシ
握り飯	ニギリメシ
握手	アクシュ
援	タスク
援兵	エンペイ
援助	エンジョ
揶揄	ヤユ
揺	ユラ
損	ソン
損害	ソンガイ
損得	ソントク
損料	ソンリョウ
携	スガル
携帯	ケイタイ
摂津	セッツ
摩擦	マサツ
摺	スリ
撫	ナデ
撮影	サツエイ
撰	セン
撲殺	ボクサツ
擂粉木	スリコギ
操	ミサオ
操行	ソウコウ
擒	トリコ
擬音	ギオン
擲	タタキ
支店	シテン
支度	シタク
支払い	シハライ
支那	シナ
支那人	シナジン
支配	シハイ
改	アラタメ
改心	カイシン
改札口	カイサツグチ
改正	カイセイ
改版	カイハン
改良	カイリョウ
攻	オサム
攻め	セメ
攻撃	コウゲキ
放げ	ホウゲ
放し	ホウシ
放任主義	ホウニンシュギ
放免	ホウメン
放心	ホウシン
放擲	ホウテキ
放棄	ホウキ
放歌	ホウカ
放水	ホウスイ
放漫	ホウマン
放蕩	ホウトウ
放言	ホウゲン
放課後	ホウカゴ
放逐	ホウチク
政体	セイタイ
政党	セイトウ
政府	セイフ
政治	セイジ
政治家	セイジカ
故	コ
故事	コジ
故人	コジン
故意	コイ
故郷	コキョウ
故障	コショウ
敏	サトシ
敏感	ビンカン
敏捷	ビンショウ
敏腕	ビンワン
救	スクイ
救い	スクイ
敗	ハイ
敗北	ハイボク
敗者	ハイシャ
教	キョウ
教え	オシエ
教員	キョウイン
教場	キョウジョウ
教壇	キョウダン
教室	キョウシツ
教師	キョウシ
教授	キョウジュ
教科書	キョウカショ
教練	キョウレン
教義	キョウギ
教育	キョウイク
教育者	キョウイクシャ
教訓	キョウクン
教頭	キョウトウ
散々	サンザン
散会	サンカイ
散文	サンブン
散歩	サンポ
敬	ケイ
敬い	ケイイ
敬具	ケイグ
敬意	ケイイ
敬愛	ケイアイ
敬服	ケイフク
敬語	ケイゴ
敬遠	ケイエン
数	カズ
数え年	カゾエドシ
数奇	スウキ
数字	スウジ
数学	スウガク
数年	スウネン
数量	スウリョウ
敲き	タタキ
整備	セイビ
整列	セイレツ
整然	セイゼン
整理	セイリ
敵	テキ
敵味方	テキミカタ
敵地	テキチ
敵愾心	テキガイシン
敵視	テキシ
敵討ち	カタキウチ
敷	シキ
敷居	シキイ
敷居越	シキイゴシ
敷島	シキシマ
敷布	シキフ
敷物	シキモノ
敷石	シキイシ
文	ブン
文久	ブンキュウ
文人	ブンジン
文句	モンク
文吾	ブンゴ
文堂	ブンドウ
文壇	ブンダン
文士	ブンシ
文字	モジ
文字どおり	モジドオリ
文字列	モジレツ
文学	ブンガク
文学者	ブンガクシャ
文房具	ブンボウグ
文才	ブンサイ
文明	ブンメイ
文献	ブンケン
文盲	モンモウ
文科	ブンカ
文章	ブンショウ
文芸	ブンゲイ
文芸倶楽部	ブンゲイクラブ
文通	ブンツウ
文部大臣	モンブダイジン
文金	ブンキン
斎正	サイショウ
斎部	インベ
斑	ムラ
斑入	フイリ
斑入り	フイリ
料	リョウ
料亭	リョウテイ
料理	リョウリ
料簡	リョウケン
斜	ハス
斜め	ナナメ
斜面	シャメン
斟酌	シンシャク
斤	キン
斥候	セッコウ
断	ダン
断り	コトワリ
断定	ダンテイ
断念	ダンネン
断案	ダンアン
断片	ダンペン
断腸	ダンチョウ
断行	ダンコウ
断言	ダンゲン
断食	ダンジキ
斯様	カヨウ
斯道	シドウ
新	シン
新しい光	アタラシイヒカリ
新た	アラタ
新世界	シンセカイ
新任	シンニン
新住民	シンジュウミン
新体詩	シンタイシ
新刊	シンカン
新劇	シンゲキ
新参	シンザン
新太郎	シンタロウ
新奇	シンキ
新婚	シンコン
新宿	シンジュク
新年	シンネン
新年宴会	シンネンエンカイ
新式	シンシキ
新形	シンガタ
新撰	シンセン
新来	シンライ
新橋	シンバシ
新機軸	シンキジク
新潟県	ニイガタケン
新潮文庫	シンチョウブンコ
新潮社	シンチョウシャ
新着	シンチャク
新築	シンチク
新編	シンペン
新聞	シンブン
新聞屋	シンブンヤ
新聞紙	シンブンシ
新聞記者	シンブンキシャ
新聞配達	シンブンハイタツ
新説	シンセツ
新調	シンチョウ
新道	シンドウ
新高	ニイタカ
新鮮	シンセン
方	ホウ
方々	カタガタ
方丈	ホウジョウ
方今	ホウコン
方便	ホウベン
方向	ホウコウ
方寸	ホウスン
方案	ホウアン
方法	ホウホウ
方眼紙	ホウガンシ
方程式	ホウテイシキ
方角	ホウガク
方角違い	ホウガクチガイ
方言	ホウゲン
方針	ホウシン
方面	ホウメン
施	シ
旁	ツクリ
旅	タビ
旅の途中で	タビノトチュウデ
旅人	タビビト
旅先	タビサキ
旅団	リョダン
旅団長	リョダンチョウ
旅客	リョカク
旅烏	タビガラス
旅行	リョコウ
旅費	リョヒ
旅順	リョジュン
旅館	リョカン
旅鴉	タビガラス
旋律	センリツ
旋毛曲り	ツムジマガリ
族	ゾク
旗	ハタ
旗下	キカ
旗本	ハタモト
旗竿	ハタザオ
既倒	キトウ
日	ヒ
日々	ヒビ
日どう	ニチドウ
日の丸	ヒノマル
日の出	ヒノデ
日の目	ヒノメ
日中	ニッチュウ
日傘	ヒガサ
日光	ニッコウ
日取り	ヒドリ
日向	ヒナタ
日和	ヒヨリ
日夜	ニチヤ
日帰り	ヒガエリ
日常	ニチジョウ
日当	ニットウ
日当り	ヒアタリ
日影	ヒカゲ
日数	ニッスウ
日暮	ヒグレ
日暮れ	ヒグレ
日曜	ニチヨウ
日月	ジツゲツ
日本	ニッポン
日本のために	ニホンノタメニ
日本一	ニッポンイチ
日本中	ニホンジュウ
日本人	ニッポンジン
日本原産	ニホンゲンサン
日本国	ニッポンコク
日本堤	ニホンヅツミ
日本文学	ニホンブンガク
日本橋	ニホンバシ
日本派	ニホンハ
日本語	ニホンゴ
日没	ニチボツ
日清	ニッシン
日清戦争	ニッシンセンソウ
日盛り	ヒザカリ
日目	ニチモク
日程	ニッテイ
日脚	ヒアシ
日英同盟	ニチエイドウメイ
日蓮	ニチレン
日蔭	ヒカゲ
日覆い	ヒオオイ
日記	ニッキ
日記帳	ニッキチョウ
日課	ニッカ
日間	ニチカン
日除	ヒヨケ
日雇	ヒヤトイ
日露	ヒツユ
日露戦争	ニチロセンソウ
日頃	ヒゴロ
旦那	ダンナ
旧	キュウ
旧交	キュウコウ
旧劇	キュウゲキ
旧友	キュウユウ
旧幕	キュウバク
旧弊	キュウヘイ
旧式	キュウシキ
旧悪	キュウアク
旧暦	キュウレキ
旧約	キュウヤク
旧記	キュウキ
旨	ムネ
早々	ソウソウ
早分り	ハヤワカリ
早口	ハヤクチ
早合点	ハヤガテン
早手	ハヤテ
早晩	ソウバン
早死	ハヤジニ
早見	ハヤミ
早計	ソウケイ
早起	ハヤキ
早足	ハヤアシ
旬	シュン
旱魃	カンバツ
旺盛	オウセイ
旻	ミン
昂奮	コウフン
昂然	コウゼン
昆布	コンブ
昆布だし	コンブダシ
昆布茶	コブチャ
昆虫	コンチュウ
昇天	ショウテン
明	アキラ
明々白々	メイメイハクハク
明き	アカキ
明くる日	アクルヒ
明け	アケ
明けがた	アケガタ
明らか	アキラカ
明後日	ミョウゴニチ
明日	アシタ
明星	ミョウジョウ
明晰	メイセキ
明朝	ミョウチョウ
明治	メイジ
明治天皇	メイジテンノウ
明治神宮	メイジジングウ
明滅	メイメツ
明珠	アケミ
明白	メイハク
明瞭	メイリョウ
明神	ミョウジン
明笛	ミンテキ
明言	メイゲン
明記	メイキ
昏睡	コンスイ
易	エキ
易水	ヤスミ
易経	エキキョウ
易者	エキシャ
昔	ムカシ
昔々	ムカシムカシ
昔時	セキジ
昔気質	ムカシカタギ
昔話	ムカシバナシ
星	ホシ
星あかり	ホシアカリ
星め	ホシメ
星図	セイズ
星座	セイザ
星明り	ホシアカリ
星月夜	ホシヅキヨ
星祭	ホシマツリ
星空観察	ホシゾラカンサツ
星辰	セイシン
星霜	セイソウ
映画	エイガ
映画鑑賞	エイガカンショウ
映画館	エイガカン
春	ハル
春さき	ハルサキ
春になったら	ハルニナッタラ
春の日	ハルノヒ
春の風	ハルノカゼ
春夏秋冬	シュンカシュウトウ
春宵	シュンショウ
春巻き	ハルマキ
春慶	シュンケイ
春日	シュンジツ
春画	シュンガ
春着	ハルギ
春風	シュンプウ
昨今	サッコン
昨夕	サクユウ
昨夜	サクヤ
昨年	サクネン
昨日	キノウ
昭代	ショウダイ
昭和	ショウワ
昭和23年	ショウワニジュウサンネン
是	ゼ
是非	ゼヒ
昼	ヒル
昼ごはん	ヒルゴハン
昼夜	チュウヤ
昼寝	ヒルネ
昼過ぎ	ヒルスギ
昼間	ヒルマ
昼飯	ヒルメシ
時	トキ
時と場合	トキトバアイ
時下	ジカ
時也	トキナリ
時事問題	ジジモンダイ
時代	ジダイ
時価	ジカ
時候	ジコウ
時分	ジブン
時分どき	ジブンドキ
時刻	ジコク
時勢	ジセイ
時半	トキハン
時大	トキヒロ
時宜	ジギ
時局	ジキョク
時折	トキオリ
時日	ジジツ
時期	ジキ
時機	ジキ
時節	ジセツ
時花	トキカ
時計	トケイ
時間	ジカン
時間割	ジカンワリ
晦渋	カイジュウ
晨	ハヤシ
晩	バン
晩酌	バンシャク
晩食	バンショク
晩飯	バンメシ
晩餐	バンサン
普及	フキュウ
普段	フダン
普段着	フダンギ
普通	フツウ
普通な	フツウナ
普陀洛	フダラク
景気	ケイキ
景色	ケシキ
晴	ハレ
晴々	ハレバレ
晴やか	ハレヤカ
晴れやか	ハレヤカ
晴朗	セイロウ
晴着	ハレギ
智	サトシ
智慧	チエ
智慮	チリョ
智者	チシャ
智謀	チボウ
智識	チシキ
暁	アカツキ
暇	ヒマ
暇乞い	イトマゴイ
暇潰し	ヒマツブシ
暑さ	アツサ
暑中	ショチュウ
暖	ダン
暖か	アタタカ
暖簾	ノレン
暗合	アンゴウ
暗室	アンシツ
暗殺者	アンサツシャ
暗然	アンゼン
暗示	アンジ
暗記	アンキ
暗誦	アンショウ
暗闇	クラヤミ
暗黒	アンコク
暗黒色	アンコクショク
暦	コヨミ
暫時	ザンジ
暮	クレ
暮し	クラシ
暮し向	クラシムキ
暮し向き	クラシムキ
暮らし	クラシ
暮れ	クレ
暮方	クレガタ
暮色蒼然	ボショクソウゼン
暴力	ボウリョク
暴君	ボウクン
暴威	ボウイ
暴慢	ボウマン
暴行	ボウコウ
暴露	バクロ
暴風雨	ボウフウウ
曖昧	アイマイ
曖昧さ回避	アイマイサカイヒ
曙光	ショコウ
曝露	バクロ
曠野	アラノ
曰く	イワク
曰く付き	イワクツキ
曲	キョク
曲がり角	マガリカド
曲り	マガリ
曲り角	マガリカド
曲折	キョクセツ
曲淵	マガリブチ
曲直	キョクチョク
曲線	キョクセン
曲者	クセモノ
更	サラ
更生	コウセイ
更紗	サラサ
書	ショ
書き	カキ
書きとめ	カキトメ
書き損	カキソンジ
書き方	カキカタ
書体	ショタイ
書信	ショシン
書冊	ショサツ
書割	カキワリ
書家	ショカ
書巻	ショカン
書庫	ショコ
書斎	ショサイ
書物	ショモツ
書状	ショジョウ
書生	ショセイ
書画	ショガ
書留	カキトメ
書籍	ショセキ
書翰	ショカン
書見	ショケン
書見台	ショケンダイ
書記	ショキ
書面	ショメン
書類	ショルイ
曹操	ソウソウ
曼珠沙華	マンジュシャゲ
曾	ソウ
最中	サイチュウ
最初	サイショ
最前	サイゼン
最古	サイコ
最大	サイダイ
最後	サイゴ
最後っ屁	サイゴッペ
最後の一句	サイゴノイック
最後の一撃	サイゴノイチゲキ
最後の手段	サイゴノシュダン
最明寺	サイミョウジ
最期	サイゴ
最短時間	サイタンジカン
最終的	サイシュウテキ
最近	サイキン
最高	サイコウ
月	ツキ
月々	ツキヅキ
月あかり	ツキアカリ
月の光	ツキノヒカリ
月下	ゲッカ
月下氷人	ゲッカヒョウジン
月並	ツキナミ
月例	ゲツレイ
月刊	ゲッカン
月夜	ツキヨ
月形	ツキガタ
月影	ツキカゲ
月日	ツキヒ
月曜	ゲツヨウ
月末	ゲツマツ
月桂寺	ゲッケイジ
月給	ゲッキュウ
月見	ツキミ
月謝	ゲッシャ
月賦	ゲップ
月長石	ゲッチョウセキ
有	ユウ
有い	ユウイ
有り	ユウリ
有之	アリユキ
有体	アリテイ
有余	ユウヨ
有利	ユウリ
有力	ユウリョク
有名	ユウメイ
有名人	ユウメイジン
有夫	ユウフ
有形無形	ユウケイムケイ
有意義	ユウイギ
有望	ユウボウ
有様	アリサマ
有為転変	ウイテンペン
有無	ウム
有用	ユウヨウ
有益	ユウエキ
有福	アリフク
朋友	ホウユウ
服	フク
服従	フクジュウ
服膺	フクヨウ
服薬	フクヤク
服装	フクソウ
朗々	ロウロウ
朗らか	ホガラカ
朗吟	ロウギン
朗読	ロウドク
朗読会	ロウドクカイ
望	モチ
望み	ノゾミ
望外	ボウガイ
望遠鏡	ボウエンキョウ
朝	アサ
朝っぱら	アサッパラ
朝な夕な	アサナユウナ
朝めし	アサメシ
朝夕	アサユウ
朝敵	チョウテキ
朝日	アサヒ
朝日新聞	アサヒシンブン
朝礼	チョウレイ
朝顔	アサガオ
朝風呂	アサブロ
朝食	チョウショク
朝飯	アサメシ
朝鮮	チョウセン
期	キ
期待	キタイ
期待外れ	キタイハズレ
期日	キジツ
期限	キゲン
朦朧	モウロウ
朦朧体	モウロウタイ
朧	オボロ
朧月	オボロヅキ
朧気	オボロゲ
木	キ
木の下	コノシタ
木の葉	コノハ
木像	モクゾウ
木原	キハラ
木強漢	ボッキョウカン
木彫	キボリ
木戸	キド
木戸口	キドグチ
木札	キフダ
木材	モクザイ
木村	キムラ
木枯	コガラシ
木枯し	コガラシ
木槿	ムクゲ
木片	モクヘン
木犀	モクセイ
木登り	キノボリ
木目	モクメ
木立	コダチ
木綿	コワタ
木苺	キイチゴ
木製	モクセイ
木越	キゴシ
木通	アケビ
木造	モクゾウ
木魚	モクギョ
未	ミ
未亡人	ミボウジン
未婚	ミコン
未曾有	ミゾウ
未来	ミライ
未来のために	ミライノタメニ
未来を	ミライヲ
未生	ミショウ
未練	ミレン
未遂	ミスイ
末	スエ
末っ子	スエッコ
末代	マツダイ
末孫	マッソン
末席	マッセキ
末座	マツザ
末期	マッキ
末流	バツリュウ
末端	マッタン
本	ホン
本もの	ホンモノ
本人	ホンニン
本会	ホンカイ
本位	ホンイ
本体	ホンタイ
本務	ホンム
本名	ホンミョウ
本因坊	ホンインボウ
本国	ホンゴク
本堂	ホンドウ
本場	ホンバ
本家	ホンケ
本屋	ホンヤ
本式	ホンシキ
本当	ホントウ
本当にあった	ホントウニアッタ
本復	ホンプク
本心	ホンシン
本性	ホンショウ
本意	ホンイ
本態	ホンタイ
本懐	ホンカイ
本所	ホンジョ
本文	ホンブン
本書	ホンショ
本来	ホンライ
本来の面目	ホンライノメンモク
本校	ホンコウ
本棚	ホンダナ
本気	ホンキ
本物	ホンモノ
本県	ホンケン
本社	ホンシャ
本筋	ホンスジ
本職	ホンショク
本能	ホンノウ
本論	ホンロン
本質	ホンシツ
本質的	ホンシツテキ
本郷	ホンゴウ
本郷台	ホンゴウダイ
本門寺	ホンモンジ
本領	ホンリョウ
本題	ホンダイ
本願寺派	ホンガンジハ
札	サツ
札幌	サッポロ
朱	シュ
朱子学	シュシガク
朱肉	シュニク
朱雀大路	スザクオオジ
朴念仁	ボクネンジン
机	ツクエ
机上	キジョウ
朽木	クチキ
杉	スギ
杉並木	スギナミキ
杉原	スギハラ
杉垣	スギガキ
杉箸	スギハシ
李	リ
杏	アンズ
杏仁	キョウニン
杏仁豆腐	アンニンドウフ
杏子	アンズ
材	ザイ
材料	ザイリョウ
材質	ザイシツ
村	ムラ
杓子	シャクシ
杖	ツエ
杜絶	トゼツ
束	タバ
束縛	ソクバク
束髪	ソクハツ
条	ジョウ
条り	ジョウリ
条件	ジョウケン
条理	ジョウリ
杢	モク
来	キ
来い	ライイ
来客	ライキャク
来年	ライネン
来意	ライイ
来月	ライゲツ
来歴	ライレキ
来着	ライチャク
来臨	ライリン
来訪	ライホウ
杭	クイ
杯	ハイ
東	ヒガシ
東の	ヒガシノ
東京	トウキョウ
東京市	トウキョウシ
東京見物	トウキョウケンブツ
東北	トウホク
東南アジア	トウナンアジア
東嶺寺	トウレイジ
東方	トウホウ
東洋	トウヨウ
東西	トウザイ
東西南北	ヨモヒロ
東郷	トウゴウ
東風	コチ
杵	キネ
松	マツ
松の木	マツノキ
松型駆逐艦	マツガタクチクカン
松平家	マツダイラケ
松樹	マツキ
松皮	マツカワ
松脂	マツヤニ
松葉杖	マツバヅエ
松風	マツカゼ
松飾	マツカザリ
板	イタ
板の間	イタノマ
板材	イタザイ
板間	イタノマ
枇杷	ビワ
枕	マクラ
枕元	マクラモト
枕辺	マクラベ
枕頭	チントウ
林	ハヤシ
林檎	リンゴ
枚	マイ
果	ハテ
果てし	ハテシ
果報者	カホウモノ
果実	カジツ
果敢	カカン
果断	カダン
果物	クダモノ
果菜類	カサイルイ
枝	エダ
枝振り	エダブリ
枝豆	エダマメ
枠	ワク
枡屋	マスヤ
枯木	カレキ
枯木寒巌	コボクカンガン
枯葉	カレハ
枳殻	カラタチ
架	カ
架橋	カキョウ
柄	エ
柏	カシワ
柏寺	カシワデラ
某	ボウ
某々	ボウボウ
某氏	ボウシ
柔	ヤワラ
柔ら	ヤワラ
柔らか	ヤワラカ
柔弱	ニュウジャク
柔毛	ジュウモウ
柔術	ジュウジュツ
柔道	ジュウドウ
柘榴	ザクロ
柚子胡椒	ユズコショウ
柱	ハシラ
柱時計	ハシラドケイ
柳	ヤナギ
柳宗元	リュウソウゲン
柳沢	ヤナギサワ
柳田國男	ヤナギタクニオ
柳町	ヤナギチョウ
柳行李	ヤナギゴウリ
柴	シバ
柴刈り	シバカリ
柴田	シバタ
柵	シガラミ
柿	カキ
柿の種	カキノタネ
栄	サカエ
栄耀	エイヨウ
栄誉	エイヨ
栄進	エイシン
栓	セン
栗	クリ
栗鼠	リス
栞	シオリ
校	コウ
校内	コウナイ
校庭	コウテイ
校歌	コウカ
校正	コウセイ
校舎	コウシャ
校長	コウチョウ
株	カブ
核果	カッカ
根	ネ
根っこ	ネッコ
根元	ネモト
根堀	ネホリ
根性	コンジョウ
根拠地	コンキョチ
根方	ネカタ
根本	コンポン
根本的	コンポンテキ
根気	コンキ
根治	コンジ
根津	ネヅ
根菜	コンサイ
根負け	コンマケ
格	カク
格別	カクベツ
格子	コウシ
格子戸	コウシド
格段	カクダン
格言	カクゲン
桁	ケタ
桂月	ケイゲツ
桃	モモ
桃型駆逐艦	モモカタクチクカン
桃太郎	モモタロウ
桃川	モモカワ
桃色	モモイロ
案	アン
案内	アンナイ
案出	アンシュツ
案外	アンガイ
桐	キリ
桔梗	キキョウ
桜	サクラ
桜の	サクラノ
桜の木	サクラノキ
桜の花	サクラノハナ
桜木町	サクラギチョウ
桜桃	オウトウ
桜餅	サクラモチ
桟	カケハシ
桧	ヒノキ
桶	オケ
桶屋	オケヤ
梁	ヤナ
梁上の君子	リョウジョウノクンシ
梃	テコ
梅	ウメ
梅の花	ウメノハナ
梅干	ウメボシ
梅月	ウメツキ
梅酢	ウメズ
梢	コズエ
梧前灯下	ゴゼントウカ
梧桐	アオギリ
梨	ナシ
梯子	ハシゴ
梵刹	ボンサツ
棍棒	コンボウ
棒	ボウ
棒立ち	ボウダチ
棒組	ボウグミ
棒鱈	ボウダラ
棕梠	シュロ
棗	ナツメ
棚	タナ
棟	ムネ
森	モリ
森々	シンシン
森の川	モリノカワ
森川町	モリカワチョウ
森閑	シンカン
棺	カン
椀	ワン
椅子	イス
植	ウエ
植付	ウエツケ
植木	ウエキ
植木屋	ウエキヤ
植木鉢	ウエキバチ
植栽	ショクサイ
植物	ショクブツ
植物園	ショクブツエン
植物学	ショクブツガク
植込	ウエコミ
椎茸	シイタケ
検	ケン
検事	ケンジ
検分	ケンブン
検査	ケンサ
検索	ケンサク
検討	ケントウ
検証	ケンショウ
検非違使	ケビイシ
椿	ツバキ
楊	パク
楊子	ヨウジ
楊枝	ヨウジ
楊梅	ヤマモモ
楓	カエデ
楕円形	ダエンガタ
楚辞	ソジ
楠	クスノキ
楢	ナラ
業	ゴウ
業つく張り	ゴウツクバリ
業務	ギョウム
業腹	ゴウハラ
楯	タテ
極	ゴク
極め	キメ
極めて	キメテ
極り	キマリ
極度	キョクド
極楽	ゴクラク
極点	キョクテン
極端	キョクタン
極致	キョクチ
楼	ロウ
楼門	ロウモン
楽	ラク
楽しみ	タノシミ
楽器	ガッキ
楽天	ラクテン
楽天的	ラクテンテキ
楽観	ラッカン
楽隊	ガクタイ
概念	ガイネン
榊原	サカキバラ
構	カマエ
構え	カマエ
構内	コウナイ
構成	コウセイ
構文	コウブン
構造	コウゾウ
槍	ヤリ
様	ヨウ
様々	サマザマ
様変り	サマガワリ
様子	ヨウス
様式	ヨウシキ
槽	ソウ
樗蒲	チョボ
標	シメギ
標本	ヒョウホン
標札	ヒョウサツ
標準	ヒョウジュン
樟	クスノキ
樟脳	ショウノウ
模	モ
模写	モシャ
模型	モケイ
模様	モヨウ
模範	モハン
模糊	モコ
権	ケン
権兵衛	ゴンベエ
権利	ケンリ
権力	ケンリョク
権助	ゴンスケ
権勢	ケンセイ
権化	ゴンゲ
権幕	ケンマク
権柄ずく	ケンペイズク
権衡	ケンコウ
権貴栄達	ケンキエイダツ
権限	ケンゲン
横	ヨコ
横っ面	ヨコッツラ
横丁	ヨコチョウ
横付け	ヨコヅケ
横取り	ヨコドリ
横合	ヨコアイ
横向	ヨコムカイ
横向き	ヨコムキ
横手	ヨコデ
横文字	ヨコモジ
横断	オウダン
横浜	ヨコハマ
横町	ヨコチョウ
横目	ヨコメ
横着	オウチャク
横腹	ヨコバラ
横行	オウコウ
横道	ヨコミチ
横顔	ヨコガオ
横風	オウフウ
樵	キコリ
樸直	ボクチョク
樹	キ
樹下石上	ジュカセキジョウ
樹齢	ジュレイ
樺色	カバイロ
樽	タル
樽木	タルキ
橄欖	カンラン
橋	ハシ
橙	ダイダイ
橙いろ	ダイダイイロ
機	キ
機会	キカイ
機外	キガイ
機嫌	キゲン
機微	キビ
機敏	キビン
機械	キカイ
機能	キノウ
機転	キテン
機鋒	キホウ
機関	キカン
機関車	キカンシャ
橡	トチ
檀家	ダンカ
檜	ヒノキ
檜木	ヒノキ
檜皮	ヒワダ
檻	オリ
櫂	カイ
櫃	ヒツ
櫓	ロ
櫛	クシ
欄干	ランカン
欄間	ランマ
欅	ケヤキ
欝	ウツ
欠	ケツ
欠け	カケ
欠け目	カケメ
欠乏	ケツボウ
欠伸	アクビ
欠勤	ケッキン
欠席	ケッセキ
欠点	ケッテン
欠片	カケラ
次	ツギ
次の間	ツギノマ
次兄	ジケイ
次女	ジジョ
次男	ジナン
次第	シダイ
次郎	ジロウ
欣	キン
欧	オウ
欧州	オウシュウ
欧文	オウブン
欲	ヨク
欲張り	ヨクバリ
欲求	ヨッキュウ
款待	カンタイ
歌	ウタ
歌声	ウタゴエ
歌留多	カルタ
歌舞伎	カブキ
歌舞伎座	カブキザ
歌舞伎揚	カブキアゲ
歓喜	カンキ
歓天喜地	カンテンキチ
歓待	カンタイ
歓楽	カンラク
歓言愉色	カンゲンユショク
歓迎	カンゲイ
歓迎会	カンゲイカイ
止	トメ
正	タダシ
正体	ショウタイ
正宗	マサムネ
正式	セイシキ
正当	セイトウ
正成	マサシゲ
正月	ショウガツ
正札	ショウフダ
正気	ショウキ
正直	ショウジキ
正確	セイカク
正義	マサヨシ
正誤	セイゴ
正銘	ショウメイ
正雄	マサオ
正面	ショウメン
此	コノ
此間	コノマ
武	タケ
武士	ブシ
武将	ブショウ
武者振	ムシャブリ
武装蜂起	ブソウホウキ
歩	フ
歩いた	アユミイタ
歩いて帰ろう	アルイテカエロウ
歩き	アルキ
歩行	ホコウ
歩調	ホチョウ
歯	ハ
歯根	シコン
歯欠	ハコボレ
歯痛	シツウ
歯磨	ハミガキ
歯軋り	ハギシリ
歳	トシ
歳月	サイゲツ
歴々	レキレキ
歴史	レキシ
歴史家	レキシカ
歴史小説	レキシショウセツ
歴史的	レキシテキ
歴然	レキゼン
死	シ
死にぞこない	シニゾコナイ
死んでもいい	シンデモイイ
死人	シニン
死体	シタイ
死別	シベツ
死因	シイン
死後	シゴ
死期	シキ
死物狂い	シニモノグルイ
死病	シビョウ
死目	シニメ
死相	シソウ
死神	シニガミ
死骸	シガイ
殉死	ジュンシ
殊	コト
殊勝	シュショウ
残	ザン
残ってる	ノコッテル
残り	ノコリ
残念	ザンネン
残酷	ザンコク
残金	ザンキン
段	ダン
段々	ダンダン
殺し	コロシ
殺伐	サツバツ
殺気	サッキ
殺生	セッショウ
殻	カラ
殿	シンガリ
殿下	デンカ
毀損	キソン
母	ハハ
母さん	カアサン
母堂	ボドウ
母親	ハハオヤ
毎	マイ
毎回	マイカイ
毎夜	マイヨ
毎年	マイトシ
毎度	マイド
毎日	マイニチ
毎日新聞	マイニチシンブン
毎晩	マイバン
毎月	マイツキ
毎朝	マイアサ
毎朝新聞	マイチョウシンブン
毒	ドク
毒そう	ドクソウ
毒気	ドクケ
毒蛇	ドクヘビ
比	ヒ
比べ	クラベ
比べ物	クラベモノ
比丘尼	ビクニ
比例	ヒレイ
比喩	ヒユ
比喩表現	ヒユヒョウゲン
比較	ヒカク
毘沙門	ビシャモン
毛	モウ
毛並	ケナミ
毛孔	ケアナ
毛布	モウフ
毛穴	ケアナ
毛筆	モウヒツ
毛糸	ケイト
毛繻子	ケジュス
毛脛	ケズネ
毛虫	ケムシ
毛髪	モウハツ
毬	マリ
毬栗	イガグリ
氏	シ
民	ミン
民族	ミンゾク
民話	ミンワ
気	キ
気づかい	キヅカイ
気なし	キナシ
気の毒	キノドク
気もち	キモチ
気をつけ	キヲツケ
気丈	キジョウ
気位	キグライ
気候	キコウ
気兼	キガネ
気分	キブン
気力	キリョク
気取り	キドリ
気合	キアイ
気合い	キアイ
気味	キミ
気多	ケタ
気弱	キヨワ
気心	キゴコロ
気性	キショウ
気持	キモチ
気持ち	キモチ
気掛り	キガカリ
気早	キバヤ
気楽	キラク
気概	キガイ
気流	キリュウ
気焔	キエン
気狂	キチガイ
気狂い	キチガイ
気立	キダテ
気色	ケシキ
気転	キテン
気軽	キガル
気違	キチガイ
気違い	キチガイ
気遣	キヅカイ
気遣い	キヅカイ
気配	ケハイ
気長	キナガ
気附	キヅケ
気風	キフウ
気魄	キハク
水	ミズ
水と油	ミズトアブラ
水の上	ミズノウエ
水ようかん	ミズヨウカン
水中	スイチュウ
水仙	スイセン
水力	スイリョク
水夫	スイフ
水島	ミズシマ
水島さん	ミズシマサン
水島寒月	ミズシマカンゲツ
水平線	スイヘイセン
水底	スイテイ
水彩画	スイサイガ
水彩絵具	スイサイエノグ
水族館	スイゾクカン
水晶	スイショウ
水月	スイゲツ
水枕	ミズマクラ
水気	ミズケ
水泡	スイホウ
水注	スイチュウ
水泳	スイエイ
水浴び	ミズアビ
水源	スイゲン
水準	スイジュン
水溜り	ミズタマリ
水瓜	スイカ
水甕	ミズガメ
水筒	スイトウ
水素	スイソ
水草	ミズクサ
水菓子	ミズガシ
水菜	ミズナ
水葵	ミズキ
水薬	ミズグスリ
水路	スイロ
水車	スイシャ
水道	スイドウ
水銀	スイギン
水門	スイモン
水際	ミズギワ
水面	スイメン
水飴	ミズアメ
水餃子	スイギョウザ
氷	コオリ
氷嚢	ヒョウノウ
氷山	ヒョウザン
氷柱	ツララ
氷水	コオリミズ
氷炭	ヒョウタン
氷解	ヒョウカイ
永久	エイキュウ
永年	エイネン
永持	ナガモチ
永日	エイジツ
永眠	エイミン
永遠	エイエン
永遠に	エイエンニ
汁	シル
汁粉	シルコ
求	モトム
求め	モトメ
求婚	キュウコン
求愛	キュウアイ
汐	シオ
汗	アセ
汚水	オスイ
汝	ナンジ
江戸	エド
江戸っ子	エドッコ
江戸前	エドマエ
江湖	コウコ
池	イケ
池の上	イケノウエ
決	ケツ
決し	ケッシ
決定	ケッテイ
決定的	ケッテイテキ
決心	ケッシン
決意	ケツイ
決戦	ケッセン
決断	ケツダン
汽笛	キテキ
汽船	キセン
汽車	キシャ
汽車に乗って	キシャニノッテ
沈	シズメ
沈み	シズミ
沈丁花	ジンチョウゲ
沈吟	チンギン
沈思	チンシ
沈澱	チンデン
沈着	チンチャク
沈静	チンセイ
沈鬱	チンウツ
沈黙	チンモク
沓脱	クツヌギ
沖	オキ
沖の	オキノ
沖縄	オキナワ
沖縄県	オキナワケン
沖縄県宜野湾市	オキナワケンギノワンシ
沙弥	サヤ
沙汰	サタ
沙河	サガ
沙漠	サバク
沙門	シャモン
没	ボツ
没交渉	ボッコウショウ
没書	ボッショ
没趣味	ボッシュミ
沢	サワ
沢山	タクサン
沢庵	タクアン
河	カワ
河内源氏	カワチゲンジ
河原	カワハラ
河原なでしこ	カワラナデシコ
河合又五郎	カワイマタゴロウ
河岸	カワギシ
河床	カショウ
河豚	フグ
河野	コウノ
油	アブラ
油壺	アブラツボ
油断	ユダン
油町	アブラマチ
油紙	ユシ
油絵	アブラエ
油蝉	アブラゼミ
治承・寿永の乱	ジショウジュエイノラン
治療	チリョウ
治癒	チユ
沼	ヌマ
沼蝦	ヌマエビ
沼辺	ヌマベ
沿岸	エンガン
泉	イズミ
泉岳寺	センガクジ
泉水	センスイ
泊り	トマリ
泊りがけ	トマリガケ
法	ホウ
法事	ホウジ
法則	ホウソク
法外	ホウガイ
法学	ホウガク
法律	ホウリツ
法眼	ホウゲン
法科	ホウカ
法蓮草	ホウレンソウ
法螺	ホラ
法螺吹	ホラフキ
法螺吹き	ホラフキ
法語	ホウゴ
泡	アワ
泡沫	ホウマツ
波	ナミ
波の間	ナミノマ
波動	ハドウ
波打際	ナミウチギワ
波瀾	ハラン
波紋	ハモン
波間	ナミマ
泣き	ナキ
泣き声	ナキゴエ
泣き寝入り	ナキネイリ
泣顔	ナキガオ
泥	ドロ
泥棒	ドロボウ
泥棒根性	ドロボウコンジョウ
泥海	ドロウミ
泥足	ドロアシ
泥酔	デイスイ
注	チュウ
注い	チュウイ
注射	チュウシャ
注射器	チュウシャキ
注意	チュウイ
注文	チュウモン
注目	チュウモク
注視	チュウシ
注釈	チュウシャク
泪	ナミダ
泰然	タイゼン
泰西	タイセイ
泳	エイ
泳ぎ	オヨギ
洋	ヨウ
洋なし	ヨウナシ
洋室	ヨウシツ
洋書	ヨウショ
洋服	ヨウフク
洋画	ヨウガ
洋画家	ヨウガカ
洋行	ヨウコウ
洒掃薪水	サイソウシンスイ
洒落	シャレ
洗	アライ
洗い	アライ
洗いざらし	アライザラシ
洗い張	アライハリ
洗い張り	アライハリ
洗い方	アライカタ
洗い晒し	アライザラシ
洗湯	セントウ
洗濯	センタク
洗髪	センパツ
洛中	ラクチュウ
洞	ホラ
洞窟	ドウクツ
津木	ツギ
津軽	ツガル
洪	ヒロシ
洲	シュウ
活	カツ
活力	カツリョク
活動	カツドウ
活字	カツジ
活気	カッキ
活溌	カッパツ
活版	カッパン
活用	カツヨウ
活発	カッパツ
活眼	カツガン
活花	イケバナ
活計	カッケイ
活躍	カツヤク
派	ハ
派出	ハシュツ
派手	ハデ
派遣	ハケン
流	リュウ
流し	ナガシ
流れ	ナガレ
流俗	リュウゾク
流儀	リュウギ
流産	リュウザン
流行	リュウコウ
流通	リュウツウ
浄土	ジョウド
浄瑠璃	ジョウルリ
浅井	アサイ
浅田宗伯	アサダソウハク
浅草	アサクサ
浅草警察署	アサクサケイサツショ
浅薄	センバク
浅黄	アサギ
浜	ハマ
浜の	ハマノ
浜田	ハマダ
浜辺	ハマベ
浣腸	カンチョウ
浦	ウラ
浦島太郎	ウラシマタロウ
浩然の気	コウゼンノキ
浪	ナミ
浪々	ロウロウ
浪の上	ナミノウエ
浪人	ロウニン
浪花節	ナニワブシ
浮	ウキ
浮き	ウキ
浮世	ウキヨ
浮彫	ウキボリ
浮気	ウワキ
浮華虚栄	フカキョエイ
浮身	ウキミ
浴	ヨク
浴場	ヨクジョウ
浴客	ヨッキャク
浴槽	ヨクソウ
浴衣	ユカタ
海	ウミ
海じ	カイジ
海の底	ウミノソコ
海へ	ウミヘ
海中	カイチュウ
海塩	ウシオ
海屋	カイオク
海岸	カイガン
海峡	カイキョウ
海水	カイスイ
海水浴	カイスイヨク
海水浴場	カイスイヨクジョウ
海浜	カイヒン
海産物	カイサンブツ
海老	エビ
海老茶	エビチャ
海苔	ノリ
海苔せんべい	ノリセンベイ
海藻	カイソウ
海軍	カイグン
海辺	ウミベ
海面	カイメン
海鮮丼	カイセンドン
海鼠	ナマコ
消し	ケシ
消しゴム	ケシゴム
消光	ショウコウ
消化	ショウカ
消息	ショウソク
消極	ショウキョク
消極主義	ショウキョクシュギ
消極的	ショウキョクテキ
消毒	ショウドク
消沈	ショウチン
消耗	ショウモウ
消費	ショウヒ
涎	ヨダレ
涙	ナミダ
液	エキ
液体	エキタイ
涼	リョウ
淀み	ヨドミ
淋	ソソギ
淑女	シュクジョ
淑徳	シュクトク
淡泊	タンパク
淫売婦	インバイフ
淫靡	インビ
深い意味	フカイイミ
深さ	フカサ
深入り	フカイリ
深夜	シンヤ
深奥	シンオウ
深緑	シンリョク
深長	シンチョウ
淳朴	ジュンボク
淵	フチ
混乱	コンラン
混同	コンドウ
混成	コンセイ
混沌	コントン
混雑	コンザツ
添乳	ソエジ
清	キヨシ
清らか	キヨラカ
清和源氏	セイワゲンジ
清国	キヨクニ
清廉	セイレン
清新	セイシン
清書	セイショ
清浄	セイジョウ
清聴	セイチョウ
清風	セイフウ
渇き	カワキ
渇仰	カツゴウ
済	スミ
済度	サイド
渉	ワタル
渉猟	ショウリョウ
渋	シブ
渋さ	シブサ
渋柿	シブガキ
渋田	シブタ
渋面	ジュウメン
渓	ケイ
渚	ナギサ
減	ゲン
減らず口	ヘラズグチ
渡り鳥	ワタリドリ
渡辺	ワタナベ
渡部	ワタナベ
渦	ウズ
温	ヌル
温厚	オンコウ
温室	オンシツ
温州みかん	ウンシュウミカン
温泉	オンセン
温泉へ行こう	オンセンヘイコウ
温泉場	オンセンバ
温泉宿	オンセンヤド
温泉旅行	オンセンリョコウ
温良篤厚	オンリョウトッコウ
温順	オンジュン
測候所	ソッコウジョ
測量	ソクリョウ
港屋	ミナトヤ
渺々	ビョウビョウ
渾名	アダナ
湖水	コスイ
湯	ユ
湯たんぽ	ユタンポ
湯に	ユニ
湯上がり	ユアガリ
湯呑	ユノミ
湯屋	ユヤ
湯島	ユシマ
湯槽	ユブネ
湯気	ユゲ
湯漬	ユヅケ
湯豆腐	ユドウフ
湯銭	ユセン
満仲	マンジュウ
満員	マンイン
満天下	マンテンカ
満山	マンザン
満干	ミチヒ
満月	マンゲツ
満期	マンキ
満樹	ミツキ
満洲	マンシュウ
満潮	マンチョウ
満点	マンテン
満腔	マンコウ
満腹	マンプク
満足	マンゾク
満身	マンシン
満面	マンメン
溌墨	ハツボク
源	ミナモト
源さん	ゲンサン
源ちゃん	ゲンチャン
源吾	ゲンゴ
源氏物語	ゲンジモノガタリ
源義朝	ミナモトノヨシトモ
源頼朝	ミナモトノヨリトモ
準備	ジュンビ
溜息	タメイキ
溜飲	リュウイン
溝	ミゾ
溷濁	コンダク
滄桑の変	ソウソウノヘン
滅	メツ
滅亡	メツボウ
滅却	メッキャク
滅多	メッタ
滅茶滅茶	メチャメチャ
滅茶苦茶	メチャクチャ
滋味	ジミ
滋養	ジヨウ
滑	ナメラ
滑らか	ナメラカ
滑り	スベリ
滑稽	コッケイ
滔々	トウトウ
滝	タキ
滞在	タイザイ
滴	シズク
漁	リョウ
漁師	リョウシ
漁村	ギョソン
漆	ウルシ
漆喰	シックイ
演	エン
演劇	エンゲキ
演奏	エンソウ
演技	エンギ
演繹	エンエキ
演習	エンシュウ
演者	エンジャ
演芸	エンゲイ
演説	エンゼツ
演説会	エンゼツカイ
演題	エンダイ
漢	カン
漢名	カンナ
漢土	カンド
漢字	カンジ
漢学	カンガク
漢学者	カンガクシャ
漢語	カンゴ
漫々	マンマン
漫然	マンゼン
漫画	マンガ
漫画家	マンガカ
漫罵	マンバ
漬物	ツケモノ
漱石	ソウセキ
漸	ウタテ
漸次	ゼンジ
潔癖	ケッペキ
潔白	ケッパク
潜り	モグリ
潜り戸	クグリド
潜伏	センプク
潜伏期	センプクキ
潤	ジュン
潮	シオ
潮水	シオミズ
潮流	チョウリュウ
潮風	シオカゼ
潸然	サンゼン
澄	キヨシ
澄し	スマシ
澱粉	デンプン
激	ゲキ
激怒	ゲキド
激賞	ゲキショウ
濃い茶	コイチャ
濠	ホリ
濡れ	ヌレ
濡手	ヌレテ
濡衣	ヌレギヌ
濫用	ランヨウ
濶	カツ
瀕	ヒン
瀟洒	ショウシャ
瀬戸	セト
瀬戸物	セトモノ
火	ヒ
火あぶり	ヒアブリ
火の手	ヒノテ
火の海	ヒノウミ
火の車	ヒノクルマ
火事	カジ
火傷	カショウ
火山活動	カザンカツドウ
火打ち	ヒウチ
火打ち石	ヒウチイシ
火桶	ヒオケ
火消	ヒケシ
火炙り	ヒアブリ
火燵	コタツ
火種	ヒダネ
火箸	ヒバシ
火鉢	ヒバチ
火鼠	カソ
灯	アカリ
灯影	ホカゲ
灯心	トウシン
灯明	トウミョウ
灯火	トモシビ
灰	ハイ
灰いろ	ハイイロ
灰吹	ハイフキ
灰汁	アク
灰色	ハイイロ
灸	ヤイト
灼然炳乎	シャクゼンヘイコ
災	ワザワイ
災難	サイナン
炊	カシキ
炎	ホノオ
炎熱	エンネツ
炬燵	コタツ
炭	スミ
炭坑	タンコウ
炯々	ケイケイ
点	テン
点々	テンテン
点か	テンカ
点検	テンケン
点滴	テンテキ
点点	テンテン
為	タメ
為替	カワセ
烈	レツ
烈火	レッカ
烏	カラス
烏うり	カラスウリ
烏合の衆	ウゴウノシュウ
烏帽子	エボシ
烏瓜	カラスウリ
烏賊	イカ
烏金	カラスガネ
烟	ケムリ
烟草	タバコ
無	ム
無い	ナイ
無いん	ナイン
無えん	ムエン
無だ	ムダ
無一文	ムイチモン
無上	ムジョウ
無事	ブジ
無二	ムニ
無人	ムジン
無人島	ムジントウ
無位無冠	ムイムカン
無何有郷	ムカウキョウ
無作法	ブサホウ
無分別	ムフンベツ
無制限	ムセイゲン
無効	ムコウ
無口	ムクチ
無名	ムメイ
無名氏	ムメイシ
無味	ムミ
無地	ムジ
無垢	ムク
無学	ムガク
無実	ムジツ
無差別	ムサベツ
無常	ムジョウ
無常迅速	ムジョウジンソク
無心	ムシン
無念	ムネン
無性	ムセイ
無惨	ムザン
無意味	ムイミ
無意義	ムイギ
無意識	ムイシキ
無愛嬌	ブアイキョウ
無愛想	ブアイソウ
無我	ムガ
無我夢中	ムガムチュウ
無才	ムサイ
無抵抗	ムテイコウ
無数	ムスウ
無料	ムリョウ
無断	ムダン
無期	ムキ
無気味	ブキミ
無沙汰	ブサタ
無法	ムホウ
無法者	ムホウモノ
無為	ムイ
無理	ムリ
無理やり	ムリヤリ
無理矢理	ムリヤリ
無用	ムヨウ
無用の長物	ムヨウノチョウブツ
無益	ムエキ
無知	ムチ
無礼	ブレイ
無神経	ムシンケイ
無粋	ブスイ
無精	ブショウ
無線	ムセン
無線電信	ムセンデンシン
無罪放免	ムザイホウメン
無聊	ブリョウ
無能	ムノウ
無能力	ムノウリョク
無花果	イチジク
無茶	ムチャ
無茶苦茶	ムチャクチャ
無要	ムヨウ
無視	ムシ
無言	ムゴン
無言劇	ムゴンゲキ
無謀	ムボウ
無責任	ムセキニン
無趣味	ムシュミ
無造作	ムゾウサ
無遠慮	ムエンリョ
無邪気	ムジャキ
無鉄砲	ムテッポウ
無関係	ムカンケイ
無闇	ムヤミ
無限	ムゲン
無難	ブナン
無頓着	ムトンジャク
無頼漢	ブライカン
無類	ムルイ
無風流	ブフウリュウ
無駄	ムダ
無駄口	ムダグチ
無駄足	ムダアシ
無駄骨	ムダボネ
焦げ	コゲ
焦慮	ショウリョ
焦熱地獄	ショウネツジゴク
焦燥	ショウソウ
焼	ヤキ
焼き	ヤキ
焼きうどん	ヤキウドン
焼きそば	ヤキソバ
焼きとり	ヤキトリ
焼き餃子	ヤキギョウザ
焼き鳥	ヤキトリ
焼とり	ヤキトリ
焼印	ヤキイン
焼打	ヤキウチ
焼物	ヤキモノ
焼畑	ヤキバタ
焼肉のたれ	ヤキニクノタレ
焼芋	ヤキイモ
焼酎	ショウチュウ
焼餅	ヤキモチ
煉瓦	レンガ
煎茶	センチャ
煎餅	センベイ
煙	ケムリ
煙出し	ケムダシ
煙幕	エンマク
煙管	キセル
煙草	タバコ
煙草屋	タバコヤ
煤	スス
煤掃	ススハキ
煥発	カンパツ
照会	ショウカイ
照準	ショウジュン
煩	ハン
煩い	ウルサイ
煩悩	ボンノウ
煩悶	ハンモン
煮つけ	ニツケ
煮汁	ニジル
煮物	ニモノ
煽動	センドウ
熊	クマ
熊坂	クマサカ
熊坂長範	クマサカチョウハン
熊笹	クマザサ
熔鉱炉	ヨウコウロ
熟	ジュク
熟慮	ジュクリョ
熟睡	ジュクスイ
熟練	ジュクレン
熟考	ジュッコウ
熟視	ジュクシ
熱	ネツ
熱々	アツアツ
熱い	アツイ
熱中	ネッチュウ
熱帯	ネッタイ
熱度	ネツド
熱心	ネッシン
熱湯	ネットウ
熱誠	ネッセイ
熾	オキ
熾烈	シレツ
燃	モユル
燈	アカリ
燈台	トウダイ
燐光	リンコウ
燕	ツバメ
燕雀	エンジャク
燗	カン
燻	イブシ
爆発	バクハツ
爪	ツメ
爪先上り	ツマサキアガリ
爪弾き	ツマビキ
爬虫類	ハチュウルイ
父	チチ
父の名	チチノナ
父兄	フケイ
父子	フシ
父様	トウサマ
父母	チチハハ
父祖	フソ
父親	チチオヤ
爺	ジイ
爺さん	ジイサン
爽快	ソウカイ
片	ヘン
片付	カタヅケ
片仮名	カタカナ
片側	カタガワ
片割れ	カタワレ
片手	カタテ
片手落	カタテオチ
片方	カタホウ
片足	カタアシ
片隅	カタスミ
版	バン
牛	ウシ
牛めし	ギュウメシ
牛丼	ギュウドン
牛乳	ギュウニュウ
牛乳瓶	ギュウニュウビン
牛乳配達	ギュウニュウハイタツ
牛糞	ギュウフン
牛肉	ギュウニク
牛舎	ギュウシャ
牛若丸	ウシワカマル
牛込	ウシゴメ
牛鍋	ギュウナベ
牛飼	ウシカイ
牡丹	ボタン
牡丹餅	ボタモチ
牡蠣	カキ
牢乎	ロウコ
牢屋	ロウヤ
牧場	ボクジョウ
牧山	マキヤマ
牧師	ボクシ
物	モノ
物々交換	ブツブツコウカン
物の数	モノノカズ
物は相談	モノハソウダン
物やわらか	モノヤワラカ
物事	モノゴト
物件	ブッケン
物体	ブッタイ
物価	ブッカ
物好き	モノズキ
物干	モノホシ
物心	ブッシン
物思い	モノオモイ
物指	モノサシ
物欲しそう	モノホシソウ
物理	ブツリ
物理学	ブツリガク
物理的	ブツリテキ
物産	ブッサン
物知り	モノシリ
物笑い	モノワライ
物置	モノオキ
物色	ブッショク
物覚え	モノオボエ
物語	モノガタリ
物識り	モノシリ
物象	ブッショウ
物質	ブッシツ
物質的	ブッシツテキ
物静か	モノシズカ
物音	モノオト
物騒	ブッソウ
特別	トクベツ
特定	トクテイ
特徴	トクチョウ
特有	トクユウ
特権	トッケン
特殊	トクシュ
特色	トクショク
特質	トクシツ
犠牲	ギセイ
犬	イヌ
犬と猿	イヌトサル
犯	ハン
犯人	ハンニン
犯罪	ハンザイ
犯罪者	ハンザイシャ
状	ジョウ
状差	ジョウサシ
状態	ジョウタイ
状況	ジョウキョウ
状袋	ジョウブクロ
狂	キョウ
狂い	クルイ
狂乱	キョウラン
狂人	キョウジン
狂喜	キョウキ
狂態	キョウタイ
狂気	キョウキ
狂瀾	キョウラン
狂瀾怒濤	キョウランドトウ
狂言	キョウゲン
狆	チン
狐	キツネ
狐付き	キツネツキ
狐火	キツネビ
狐狸	コリ
狐疑	コギ
狡猾	コウカツ
狡猾な	コウカツナ
狩り	カリ
狩野	カノ
独	ドク
独り	ヒトリ
独り言	ヒトリゴト
独創	ドクソウ
独力	ドクリョク
独断専行	ドクダンセンコウ
独特	ドクトク
独立	ドクリツ
独習	ドクシュウ
独言	ヒトリゴト
独身	ドクシン
独逸	ドイツ
狸	タヌキ
狼	オオカミ
狼煙	ノロシ
狼狽	ロウバイ
狼藉	ロウゼキ
猛烈	モウレツ
猛然	モウゼン
猛虎	モウコ
猛進	モウシン
猜疑	サイギ
猜疑心	サイギシン
猟	リョウ
猥談	ワイダン
猪口	チョコ
猪口才	チョコザイ
猫	ネコ
猫々	ネコネコ
猫なで声	ネコナデゴエ
猫のように	ネコノヨウニ
猫の恋	ネコノコイ
猫の額	ネコノヒタイ
猫も杓子も	ネコモシャクシモ
猫又	ネコマタ
猫撫で声	ネコナデゴエ
猫撫声	ネコナデゴエ
猫背	ネコゼ
猫被り	ネコカブリ
猫足	ネコアシ
献上	ケンジョウ
献立	コンダテ
献納	ケンノウ
献酬	ケンシュウ
猶予	ユウヨ
猶太	ナオタ
猿	サル
猿梨	サルナシ
猿楽町	サルガクチョウ
猿股	サルマタ
猿轡	サルグツワ
獄	ゴク
獅	シシ
獅子	シシ
獣	シシ
獣類	ジュウルイ
獰悪	ドウアク
玄	ゲン
玄妙	ゲンミョウ
玄関	ゲンカン
率直	ソッチョク
玉	タマ
玉の輿	タマノコシ
玉子	タマゴ
玉座	ギョクザ
玉手箱	タマテバコ
玉杯	ギョクハイ
玉椿	タマツバキ
玉突き	タマツキ
玉葱	タマネギ
玉蜀黍	トウモロコシ
王	オウ
王族	オウゾク
王林	オウリン
王様	オウサマ
王者	オウジャ
珊瑚	サンゴ
珍	チン
珍事	チンジ
珍味	チンミ
珍品	チンピン
珍妙	チンミョウ
珍宝	チンポウ
珍客	チンキャク
珍重	チンチョウ
珠	タマ
珠数	ジュズ
現今	ゲンコン
現代	ゲンダイ
現代人	ゲンダイジン
現前	ゲンゼン
現在	ゲンザイ
現場	ゲンバ
現実	ゲンジツ
現実世界	ゲンジツセカイ
現実界	ゲンジツカイ
現状維持	ゲンジョウイジ
現象	ゲンショウ
現象世界	ゲンショウセカイ
現金	ゲンキン
球	タマ
球根	キュウコン
理	リ
理学	リガク
理屈	リクツ
理性	リセイ
理想	リソウ
理由	リユウ
理科	リカ
理窟	リクツ
理解	リカイ
理解力	リカイリョク
理詰	リヅメ
理論	リロン
理野	サトノ
理非	リヒ
琉球	リュウキュウ
琥珀	コハク
琳	リン
琴	キン
琴瑟	キンシツ
琴瑟調和	キンシツチョウワ
琴線	キンセン
琵琶	ビワ
瑣事	サジ
環	タマキ
瓜	ウリ
瓜二つ	ウリフタツ
瓢箪	ヒョウタン
瓦	カワラ
瓦斯	ガス
瓦解	ガカイ
瓶	ビン
甍	イラカ
甕	ウ
甘夏	アマナツ
甘干	アマボシ
甘干し	アマボシ
甘木	アマギ
甘納豆	アマナットウ
甘茶	アマチャ
甚兵衛	ジンベエ
甜麺醤	テンメンジャン
生	ナマ
生々	セイセイ
生え際	ハエギワ
生か	ショウカ
生きもの	イキモノ
生き物	イキモノ
生ける屍	イケルシカバネ
生しいたけ	ナマシイタケ
生じ	キジ
生まれ	ウマレ
生れ	ウマレ
生れ故郷	ウマレコキョウ
生前	セイゼン
生半可	ナマハンカ
生卵	ナマタマゴ
生命	セイメイ
生国	ショウゴク
生垣	イケガキ
生埋め	イキウメ
生姜	ショウガ
生存	セイゾン
生家	セイカ
生徒	セイト
生息	セイソク
生意気	ナマイキ
生憎	アイニク
生捕	イケドリ
生死	セイシ
生死事大	ショウジジダイ
生活	セイカツ
生活費	セイカツヒ
生涯	ショウガイ
生焼け	ナマヤケ
生理	セイリ
生理的	セイリテキ
生産	セイサン
生真面目	キマジメ
生者必滅	ショウジャヒツメツ
生蕃	セイバン
生薬	キグスリ
生計	セイケイ
生身	ナマミ
生返事	ナマヘンジ
生長	セイチョウ
生霊	イキリョウ
生鮮	セイセン
産	サン
産地	サンチ
産婆	サンバ
産気	サンケ
産物	サンブツ
甥	オイ
用	ヨウ
用事	ヨウジ
用件	ヨウケン
用具	ヨウグ
用品	ヨウヒン
用心	ヨウジン
用意	ヨウイ
用材	ヨウザイ
用箋	ヨウセン
用箪笥	ヨウダンス
用紙	ヨウシ
用途	ヨウト
用達	ヨウタシ
田	タ
田圃	タンボ
田地	デンチ
田尻	タジリ
田楽	デンガク
田畑	タハタ
田舎	イナカ
田舎もの	イナカモノ
田舎家	イナカヤ
田舎者	イナカモノ
田舎言葉	イナカコトバ
由	ユカリ
由井	ユイ
由来	ユライ
由緒	ユイショ
甲	カブト
甲ら	コウラ
甲州	コウシュウ
甲斐	カイ
甲板	カンパン
甲羅	コウラ
甲虫	カブトムシ
申	サル
申し出	モウシデ
申し分	モウシブン
申し訳	モウシワケ
申し込	モウシコミ
申し込み	モウシコミ
男	オトコ
男と女	オトコトオンナ
男なら	オトコナラ
男の子	オトコノコ
男まさり	オトコマサリ
男児	ダンジ
男同志	オトコドウシ
男女	ダンジョ
男子	ダンシ
男性	ダンセイ
男振り	オトコブリ
男爵	ダンシャク
町	マチ
町はずれ	マチハズレ
町並	マチナミ
町人	チョウニン
町内	チョウナイ
画	ガ
画びょう	ガビョウ
画塾	ガジュク
画家	ガカ
画工	ガコウ
画才	ガサイ
画用紙	ガヨウシ
画集	ガシュウ
画面	ガメン
画題	ガダイ
画風	ガフウ
界	サカイ
界隈	カイワイ
畏怖	イフ
畏敬	イケイ
畏服	イフク
畏縮	イシュク
畑	ハタケ
留	トメ
留め	トメ
留任	リュウニン
留保	リュウホ
留守	ルス
留守居	ルスイ
留守番	ルスバン
畜生	チクショウ
畠	ハタケ
略	リャク
略語	リャクゴ
番	バン
番人	バンニン
番兵	バンペイ
番号	バンゴウ
番地	バンチ
番目	バンメ
番茶	バンチャ
番附	バンヅケ
番頭	バンガシラ
異	アヤ
異人種	イジンシュ
異体同心	イタイドウシン
異名	イミョウ
異境	イキョウ
異存	イゾン
異常	イジョウ
異彩	イサイ
異性	イセイ
異様	イヨウ
異母弟	イボテイ
異状	イジョウ
異端	イタン
異色	イショク
異説	イセツ
異議	イギ
異類	イルイ
畳	タタミ
畳鰯	タタミイワシ
畷	ナワテ
疋	ヒキ
疎遠	ソエン
疎開	ソカイ
疑い	ウタガイ
疑問	ギモン
疑団	ギダン
疑念	ギネン
疑惑	ギワク
疝気	センキ
疥癬	カイセン
疫病	ヤクビョウ
疱瘡	ホウソウ
疲れ	ツカレ
疲労	ヒロウ
疳	カン
疵	キズ
疾風	シップウ
病	ヤマイ
病み上り	ヤミアガリ
病人	ビョウニン
病名	ビョウメイ
病室	ビョウシツ
病家	ビョウカ
病床	ビョウショウ
病弱	ビョウジャク
病棟	ビョウトウ
病気	ビョウキ
病状	ビョウジョウ
病症	ビョウショウ
病癖	ビョウヘキ
病者	ビョウシャ
病身	ビョウシン
病院	ビョウイン
症状	ショウジョウ
痕	アト
痘痕	イモ
痙攣	ケイレン
痛	イタ
痛く	ツウク
痛み	イタミ
痛切	ツウセツ
痛快	ツウカイ
痛憤	ツウフン
痛手	イタデ
痛烈	ツウレツ
痛痒	ツウヨウ
痛苦	ツウク
痣	アザ
痩我慢	ヤセガマン
痰	タン
瘋癲	フウテン
瘤	コブ
瘧	オコリ
療法	リョウホウ
療養	リョウヨウ
癇	カン
癇癪	カンシャク
癇癪持ち	カンシャクモチ
癇癪玉	カンシャクダマ
癈人	ハイジン
癒	イユ
癖	クセ
癪	シャク
癪に障る	シャクニサワル
癪持	シャクモチ
癪持ち	シャクモチ
癲癇	テンカン
発	ハツ
発作	ホッサ
発句	ホック
発奮	ハップン
発射	ハッシャ
発展	ハッテン
発揚	ハツヨウ
発揮	ハッキ
発明	ハツメイ
発熱	ハツネツ
発狂	ハッキョウ
発現	ハツゲン
発生	ハッセイ
発着	ハッチャク
発破	ハッパ
発祥	ハッショウ
発端	ホッタン
発行	ハッコウ
発表	ハッピョウ
発見	ハッケン
発覚	ハッカク
発議	ホツギ
発車	ハッシャ
発達	ハッタツ
発音	ハツオン
登り	ノボリ
登場	トウジョウ
登山	トザン
登校	トウコウ
登用	トウヨウ
白	シロ
白い	シロイ
白いと	シライト
白いシャツ	シロイシャツ
白いリボン	シロイリボン
白い道	シロイミチ
白こしょう	シロコショウ
白だし	シロダシ
白と黒	シロトクロ
白兎	シロウサギ
白切符	シロキップ
白和え	シラアエ
白墨	ハクボク
白昼	ハクチュウ
白服	シロフク
白木	シラキ
白木屋	シラキヤ
白楽天	ハクラクテン
白牛	シラウシ
白状	ハクジョウ
白痴	ハクチ
白百合	シラユリ
白眉	ハクビ
白眼	ハクガン
白石	シライシ
白磁	ハクジ
白粉	オシロイ
白紙	ハクシ
白絣	シロガスリ
白菜	ハクサイ
白衣	ハクイ
白銀町	シロガネマチ
白銅	ハクドウ
白雨	ハクウ
白雪	シラユキ
白雲	シラクモ
白骨	ハッコツ
白髪	ハクハツ
白鳥	シラトリ
白黒	シロクロ
百	ヒャク
百じ	ヒャクジ
百万両	ヒャクマンリョウ
百人一首	ヒャクニンイッシュ
百坪	ヒャクツボ
百姓	ヒャクショウ
百年目	ヒャクネンメ
百方	ヒャッポウ
百日	モモヒ
百歳	モモトセ
百獣	ヒャクジュウ
百科事典	ヒャッカジテン
百科全書	ヒャッカゼンショ
的	テキ
的中	テキチュウ
皆	ミナ
皆さん	ミナサン
皆川	ミナカワ
皆様	ミナサマ
皆済	カイサイ
皆無	カイム
皇	スメラギ
皇子	オウジ
皇帝陛下	コウテイヘイカ
皎	コウ
皮	カワ
皮下	ヒカ
皮癬	ヒゼン
皮肉	ヒニク
皮膚	ヒフ
皺	シワ
皺くちゃ	シワクチャ
皿	サラ
皿うどん	サラウドン
盃	サカズキ
盆	ボン
盆暮	ボンクレ
益	エキ
盗	ト
盗人	ヌスビト
盗賊	トウゾク
盗難	トウナン
盛	モリ
盛り	モリ
盛ん	サカン
盛会	セイカイ
盛典	セイテン
盛名	セイメイ
盛大	セイダイ
盛徳	セイトク
監獄	カンゴク
監理	カンリ
監督	カントク
監視	カンシ
盤	バン
盤上	バンジョウ
盤台	バンダイ
盤面	バンメン
盥	タライ
目	メ
目くばせ	メクバセ
目の子	メノコ
目まい	メマイ
目下	モッカ
目付	メツケ
目出	メデ
目刺	メザシ
目安	メヤス
目打ち	メウチ
目撃	モクゲキ
目方	メカタ
目標	モクヒョウ
目玉焼き	メダマヤキ
目白	メジロ
目的	モクテキ
目的物	モクテキブツ
目盛り	メモリ
目眩	メマイ
目糞	メクソ
目縁	マブチ
目見	マミ
目覚	メザメ
目貫	メヌキ
目障り	メザワリ
盲	メクラ
盲目	モウモク
直	タダシ
直ぐ	スグ
直し	ナオシ
直径	チョッケイ
直感	チョッカン
直截	チョクセツ
直接	チョクセツ
直系	チョッケイ
直線	チョクセン
直行	チョッコウ
直覚	チョッカク
直角	チョッカク
相	アイ
相互	ソウゴ
相和	ソウワ
相場	ソウバ
相好	ソウゴウ
相宿	アイヤド
相対	ソウタイ
相当	ソウトウ
相応	ソウオウ
相思	ソウシ
相思相愛	ソウシソウアイ
相手	アイテ
相撲	スモウ
相撲取	スモウトリ
相槌	アイヅチ
相生村	アウムラ
相続	ソウゾク
相続人	ソウゾクニン
相良	サガラ
相談	ソウダン
相貌	ソウボウ
相違	ソウイ
盾	タテ
省	ショウ
省略	ショウリャク
省線	ショウセン
眉	マユ
眉毛	マユゲ
眉目	ビモク
眉間	ミケン
看守	カンシュ
看板	カンバン
看病	カンビョウ
看破	カンパ
看護	カンゴ
看護婦	カンゴフ
看過	カンカ
県	ケン
県会	ケンカイ
県庁	ケンチョウ
真	シン
真っ直	マッスグ
真っ裸	マッパダカ
真一文字	マイチモンジ
真下	マシタ
真中	マンナカ
真丸	マンマル
真也	シンヤ
真人間	マニンゲン
真似	マネ
真先	マッサキ
真向	マッコウ
真夏	マナツ
真夜中	マヨナカ
真宗	シンシュウ
真宗寺	シンシュウジ
真実	シンジツ
真弓	マユミ
真心	マゴコロ
真情	シンジョウ
真暗	マックラ
真暗闇	マックラヤミ
真最中	マッサイチュウ
真正	シンセイ
真正面	マッショウメン
真率	シンソツ
真珠	シンジュ
真理	シンリ
真白	マッシロ
真直	マッスグ
真相	シンソウ
真砂町	マサゴチョウ
真空	シンクウ
真赤	マッカ
真逆	マギャク
真逆様	マッサカサマ
真鍮	シンチュウ
真面目	マジメ
真顔	マガオ
真黒	マックロ
眠	ネムリ
眠り	ネムリ
眠気	ネムケ
眩暈	メマイ
眷属	ケンゾク
眷顧	ケンコ
眸	ヒトミ
眺め	ナガメ
眺望	チョウボウ
眺望佳絶	チョウボウカゼツ
眼	メ
眼下	ガンカ
眼中	ガンチュウ
眼前	ガンゼン
眼球	ガンキュウ
眼窩	ガンカ
眼識	ガンシキ
眼鏡	メガネ
着	チャク
着付け	キツケ
着倒れ	キダオレ
着席	チャクセキ
着手	チャクシュ
着服	チャクフク
着物	キモノ
睡眠	スイミン
睡眠時間	スイミンジカン
睡蓮	スイレン
睥睨	ヘイゲイ
睨み	ニラミ
瞑想	メイソウ
瞞着	マンチャク
瞥見	ベッケン
瞬	マドカ
瞬時	シュンジ
瞬間	シュンカン
瞭然	リョウゼン
瞳	ヒトミ
瞳孔	ドウコウ
瞼	マブタ
矛盾	ムジュン
矢	ヤ
矢先	ヤサキ
知	チ
知らず	シラズ
知らせ	シラセ
知らぬが仏	シラヌガホトケ
知らぬ顔	シラヌカオ
知らん振り	シランプリ
知らん顔	シランカオ
知り合い	シリアイ
知るべ	シルベ
知事	チジ
知人	チジン
知名	チメイ
知己	チキ
知識	チシキ
短	タン
短冊	タンザク
短文	タンブン
短日月	タンジツゲツ
短歌	タンカ
短篇	タンペン
短評	タンピョウ
矮小	ワイショウ
矯正	キョウセイ
矯風会	キョウフウカイ
石	イシ
石か	セキカ
石の下	イシノシタ
石上	イシガミ
石上麻呂	イソノカミノマロ
石作皇子	イシヅクリノミコ
石塔	セキトウ
石壁	イシカベ
石屋	イシヤ
石榴	ザクロ
石橋	イシバシ
石段	イシダン
石油	セキユ
石火	セッカ
石灯籠	イシドウロウ
石灰	セッカイ
石炭	セキタン
石狩鍋	イシカリナベ
石造	セキゾウ
石鹸	セッケン
砂	スナ
砂利	ジャリ
砂地	スナジ
砂子	スナゴ
砂浜	スナハマ
砂糖	サトウ
砂糖水	サトウミズ
砂金	シャキン
砌	ミギリ
研究	ケンキュウ
研究会	ケンキュウカイ
砲	ホウ
砲丸	ホウガン
砲兵	ホウヘイ
砲手	ホウシュ
砲撃	ホウゲキ
砲火	ホウカ
砲術	ホウジュツ
破れ	ヤブレ
破れかぶれ	ヤブレカブレ
破壊	ハカイ
破天荒	ハテンコウ
破片	ハヘン
破目	ハメ
破約	ハヤク
破裂	ハレツ
破談	ハダン
硝子	ガラス
硫黄	イオウ
硯	スズリ
碁	ゴ
碁盤	ゴバン
碁石	ゴイシ
碌	ロク
碌々	ロクロク
碍子	ガイシ
碑	イシブミ
碗	ワン
確	カク
確か	タシカ
確信	カクシン
確実	カクジツ
確然	カクゼン
磁力	ジリョク
磁気	ジキ
磊落	ライラク
磔	ハリツケ
磨	ミガク
磬	カオル
磯	イソ
礫	ツブテ
礼	レイ
礼儀	レイギ
礼儀作法	レイギサホウ
礼拝	レイハイ
礼服	レイフク
社	シャ
社交	シャコウ
社会	シャカイ
社会的	シャカイテキ
社員	シャイン
祈り	イノリ
祈念	キネン
祈願	キガン
祐筆	ユウヒツ
祖	ソ
祖先神	ソセンシン
祖母	ソボ
祖父	ソフ
祝	シュク
祝勝	シュクショウ
祝勝会	シュクショウカイ
祝宴	シュクエン
祝捷	シュクショウ
祝福	シュクフク
祝言	シュウゲン
祝詞	ノリト
祝賀	シュクガ
神	カミ
神か	シンカ
神さま	カミサマ
神の子	カミノコ
神仏	シンブツ
神保町	ジンボウチョウ
神国	シンコク
神妙	シンミョウ
神宮	ジングウ
神戸	コウベ
神曲	カミキョク
神楽	カグラ
神楽坂	カグラザカ
神様	カミサマ
神田	カンダ
神社	ジンジャ
神祇	ジンギ
神秘	シンピ
神秘的	シンピテキ
神経	シンケイ
神経衰弱	シンケイスイジャク
神経質	シンケイシツ
神聖	シンセイ
神輿	シンヨ
神酒	ミキ
神頼み	カミダノミ
祭	マツリ
祭り	マツリ
祭壇	サイダン
祭日	サイジツ
禁欲	キンヨク
禁足	キンソク
禁錮	キンコ
禅	ゼン
禅学	ゼンガク
禅宗	ゼンシュウ
禅家	ゼンケ
禅師	ゼンジ
禍	ワザワイ
福	フク
福地	フクチ
福音	フクイン
禿	カムロ
禿頭	ハゲアタマ
秀才	シュウサイ
秀衡	ヒデヒラ
私	ワタシ
私しゃ	ワタシャ
私たち	ワタシタチ
私のように	ワタシノヨウニ
私の国	ワタシノクニ
私の秘密	ワタシノヒミツ
私の運命	ワタシノウンメイ
私の部屋	ワタシノヘヤ
私ゃ	ワタシャ
私儀	ワタクシギ
私共	ワタクシドモ
私情	シジョウ
私有	シユウ
私立	シリツ
私自身	ワタシジシン
私語	シゴ
秋	アキ
秋の	アキノ
秋冷	シュウレイ
秋田	アキタ
秋野	アキノ
秋風	アキカゼ
科	カ
科学	カガク
秒	ビョウ
秘密	ヒミツ
秘法	ヒホウ
秘蔵	ヒゾウ
秘術	ヒジュツ
秩序	チツジョ
称	ショウ
移り	ウツリ
稀	マレ
稀代	キタイ
稀少	キショウ
稀有	ケウ
稀薄	キハク
程	ホド
程度	テイド
税	ゼイ
稚拙	チセツ
稚気	チキ
稜	リョウ
種	タネ
種々	シュジュ
種取り	タネトリ
種子	シュシ
種族	シュゾク
種類	シュルイ
稲	イネ
稲作	イナサク
稲光	イナビカリ
稲刈	イネカリ
稲妻	イナヅマ
稽古	ケイコ
稿	コウ
稿本	コウホン
穀	コク
穀潰し	ゴクツブシ
穀物	コクモツ
穀物酢	コクモツス
穂	ホ
積	セキ
積みかさね	ツミカサネ
積り	ツモリ
積極	セッキョク
積極主義	セッキョクシュギ
積極的	セッキョクテキ
穏やか	オダヤカ
穏便	オンビン
穏当	オントウ
穴	アナ
穴あけ	アナアケ
穴守稲荷	アナモリイナリ
空	ソラ
空々	クウクウ
空い	クウイ
空っぽ	カラッポ
空の中	ソラノナカ
空中	クウチュウ
空也	クウヤ
空前	クウゼン
空名	クウメイ
空地	クウチ
空室	アキシツ
空家	アキヤ
空席	クウセキ
空模様	ソラモヨウ
空気	クウキ
空気銃	クウキジュウ
空海	クウカイ
空漠	クウバク
空白	クウハク
空箱	カラバコ
空缶	アキカン
空腹	クウフク
空虚	クウキョ
空襲	クウシュウ
空豆	ソラマメ
空費	クウヒ
空転	クウテン
空間	クウカン
突かけ	ツッカケ
突き	ツキ
突き当り	ツキアタリ
突ッ込	ツッコミ
突起	トッキ
突込	ツッコミ
突進	トッシン
突飛	トッピ
窃か	ヒソカ
窒息	チッソク
窓	マド
窓をあけて	マドヲアケテ
窟	イワヤ
窮	キュウ
窮境	キュウキョウ
窮屈	キュウクツ
窮措大	キュウソダイ
窺	ウカガイ
窺知	キチ
竈	カマド
立	タツ
立ち	タチ
立つ瀬	タツセ
立て	ダテ
立ん坊	タチンボウ
立場	タチバ
立方	リッポウ
立木	タチキ
立派	リッパ
立町	タテマチ
立腹	リップク
立膝	タテヒザ
立葵	タチアオイ
立見	タチミ
立身出世	リッシンシュッセ
竜	リュウ
竜宮	リュウグウ
竜岡町	タツオカチョウ
竜泉	リュウセン
竜田揚げ	タツタアゲ
竜胆	リンドウ
竜頭蛇尾	リュウトウダビ
竜騰虎闘	リュウトウコトウ
竟	キワム
章	アキラ
章魚	タコ
竣功	シュンコウ
童女	ドウジョ
童子	ドウジ
竪	タテ
竪琴	タテゴト
竪町	タテマチ
端	ハジ
端坐	タンザ
端書	ハシガキ
端正	タンセイ
端渓	タンケイ
端緒	タンショ
競	ケイ
競争	キョウソウ
競技	キョウギ
競馬	ケイバ
竹	タケ
竹を割ったよう	タケヲワッタヨウ
竹一	タケイチ
竹刀	シナイ
竹垣	タケガキ
竹林	チクリン
竹槍	タケヤリ
竹葉	タケバ
竹輪	チクワ
竿	サオ
笊	ザル
笊蕎麦	ザルソバ
笑	エミ
笑い	ワライ
笑いごと	ワライゴト
笑い事	ワライゴト
笑い声	ワライゴエ
笑い草	ワライグサ
笑う門には福来る	ワラウカドニハフクキタル
笑声	ショウセイ
笑止千万	ショウシセンバン
笑顔	エガオ
笛	フエ
笞	ムチ
笠	カサ
符	フ
第一	ダイイチ
第一位	ダイイチイ
第一歩	ダイイッポ
第一流	ダイイチリュウ
第一義	ダイイチギ
第三紀	ダイサンキ
第五	ダイゴ
笹	ササ
笹原	ササハラ
笹山	ササヤマ
筆	フデ
筆ペン	フデペン
筆太	フデブト
筆法	ヒッポウ
筆硯	ヒッケン
筆箱	フデバコ
筆致	ヒッチ
筆誅	ヒッチュウ
筈	ハズ
等	ヒトシ
等分	トウブン
筋	スジ
筋肉	キンニク
筋道	スジミチ
筋違	スジチガイ
筋頭	スジガシラ
筍	タケノコ
筑前煮	チクゼンニ
筑摩	チクマ
筑摩書房	チクマショボウ
筒	ツツ
筒袖	ツツソデ
答	コタエ
答え	コタエ
答弁	トウベン
答案	トウアン
策	サク
策略	サクリャク
筧	カケイ
箆	ヘラ
箇所	カショ
箇月	カゲツ
箍	タガ
箒	ホウキ
箔	ハク
算	サン
算段	サンダン
算盤	ソロバン
算術	サンジュツ
管	カン
管理人	カンリニン
管轄	カンカツ
箪笥	タンス
箱	ハコ
箱根	ハコネ
箸	ハシ
節	フシ
節奏	セッソウ
節季	セッキ
節約	セツヤク
範囲	ハンイ
篇	ヘン
築地	ツキジ
築山	ツキヤマ
篤実	トクジツ
篦棒	ベラボウ
簀	ス
簡便	カンベン
簡単	カンタン
簡明	カンメイ
簡略	カンリャク
簿	ボ
籍	セキ
籐椅子	トウイス
籠	カゴ
米	ベイ
米国	ベイコク
米国人	ベイコクジン
米粒	コメツブ
米酢	コメズ
粉	コナ
粉薬	コグスリ
粋	イキ
粒	ツブ
粗忽	ソコツ
粗悪	ソアク
粗暴	ソボウ
粗末	ソマツ
粗略	ソリャク
粗葉	ソハ
粗野	ソヤ
粘着	ネンチャク
粛	ススム
粛然	シュクゼン
粛粛	シュクシュク
粟粒	アワツブ
粥	カユ
精	セイ
精一杯	セイイッパイ
精力	セイリョク
精密	セイミツ
精根	セイコン
精油	セイユ
精神	セイシン
精神病	セイシンビョウ
精神病者	セイシンビョウシャ
精神的	セイシンテキ
精細	セイサイ
精読	セイドク
精進	ショウジン
糅	カテ
糊	ノリ
糊口	ココウ
糞	クソ
糞度胸	クソドキョウ
糟	カス
糟糠の妻	ソウコウノツマ
糠	ヌカ
糠味噌	ヌカミソ
糠漬け	ヌカヅケ
糸	イト
糸巻	イトマキ
糸瓜	ヘチマ
糸織	イトオリ
系図	ケイズ
系統	ケイトウ
系統的	ケイトウテキ
糾合	キュウゴウ
紀	キノ
紀伊	キイ
約定	ヤクジョウ
約束	ヤクソク
紅	ベニ
紅塵	コウジン
紅梅	コウバイ
紅涙	コウルイ
紅白	コウハク
紅色	コウショク
紅茶	コウチャ
紅葉	コウヨウ
紋	モン
紋付	モンツキ
納	オサメ
納得	ナットク
納戸	ナンド
納涼	ノウリョウ
紐	ヒモ
純	ジュン
純然	ジュンゼン
純白	ジュンパク
純粋	ジュンスイ
紙	カミ
紙きれ	カミキレ
紙上	シジョウ
紙切れ	カミキレ
紙屑	カミクズ
紙幣	シヘイ
紙燭	シソク
紙片	シヘン
紙袋	カミブクロ
紙鳶	イカノボリ
級	キュウ
級友	キュウユウ
紛々	フンプン
紛れ	マギレ
紛失	フンシツ
紛然雑然	フンゼンザツゼン
素	モト
素人	シロウト
素性	ソセイ
素振	ソブリ
素敵	ステキ
素晴	スバル
素琴	ソキン
素直	スナオ
素肌	スハダ
素袷	スアワセ
素足	スアシ
素通り	スドオリ
索然	サクゼン
紫	ムラサキ
紫いろ	ムラサキイロ
紫檀	シタン
紫色	ムラサキイロ
紫蘇	シソ
紬	ツムギ
累々	ルイルイ
細	ホソ
細か	コマカ
細君	サイクン
細大	サイダイ
細字	サイジ
細工	ザイク
細渕	ホソブチ
細目	ホソメ
細胞	サイボウ
細道	ホソミチ
紳士	シンシ
紹介	ショウカイ
紺	コン
紺屋	コンヤ
終	オワリ
終り	オワリ
終了	シュウリョウ
終夜	シュウヤ
終局	シュウキョク
終日	シュウジツ
終身	シュウシン
絃	イト
組	クミ
組織	ソシキ
経	ケイ
経歴	ケイレキ
経済	ケイザイ
経済問題	ケイザイモンダイ
経緯	ケイイ
経過	ケイカ
経験	ケイケン
結	ユイ
結び	ムスビ
結び目	ムスビメ
結合	ケツゴウ
結城紬	ユウキツムギ
結婚	ケッコン
結婚の条件	ケッコンノジョウケン
結婚式	ケッコンシキ
結婚後	ケッコンゴ
結局	ケッキョク
結成	ケッセイ
結末	ケツマツ
結果	ケッカ
結構	ケッコウ
結滞	ケッタイ
結論	ケツロン
絛虫	サナダムシ
絞殺	コウサツ
絞首	コウシュ
絢爛	ケンラン
絣	カスリ
給	キュウ
給仕	キュウジ
絨緞	ジュウタン
統監	トウカン
統計	トウケイ
絵	エ
絵の具	エノグ
絵巻物	エマキモノ
絵師	エシ
絵本	エホン
絵画	カイガ
絵筆	エフデ
絵葉書	エハガキ
絶	ゼッ
絶交	ゼッコウ
絶体絶命	ゼッタイゼツメイ
絶壁	ゼッペキ
絶対	ゼッタイ
絶後	ゼツゴ
絶息	ゼッソク
絶景	ゼッケイ
絶望	ゼツボウ
絶滅危惧種	ゼツメツキグシュ
絶縁	ゼツエン
絶間	タエマ
絹	キヌ
継ぎ	ツギ
継子あつかい	ママコアツカイ
継母	ケイボ
継続	ケイゾク
続き	ツヅキ
続きあい	ツヅキアイ
続けざま	ツヅケザマ
続け様	ツヅケザマ
綜合	ソウゴウ
維持	イジ
維新	イシン
綯	ナエ
綱	ツナ
綱渡り	ツナワタリ
綱目	コウモク
綱要	コウヨウ
網棚	アミダナ
網羅	モウラ
綴	ツヅリ
綴り	ツヅリ
綺羅	キラ
綺麗	キレイ
綾錦	アヤニシキ
綿	メン
綿ネル	メンネル
綿入	ワタイレ
緊張	キンチョウ
緋	ヒ
総	ソウ
総代	ソウダイ
総会	ソウカイ
総数	ソウスウ
総称	ソウショウ
総身	ソウシン
総長	ソウチョウ
緑	ミドリ
緑いろ	ミドリイロ
緑の黒髪	ミドリノクロカミ
緒	イトグチ
線	セン
線路	センロ
線香	センコウ
緞帳役者	ドンチョウヤクシャ
締切	シメキリ
編上	アミアゲ
編入	ヘンニュウ
編者	ヘンシャ
編輯	ヘンシュウ
編集	ヘンシュウ
緩やか	ユルヤカ
練	ネリ
練り	ネリ
練兵	レンペイ
練習	レンシュウ
緻密	チミツ
縁	エン
縁側	エンガワ
縁台	エンダイ
縁故	エンコ
縁日	エンニチ
縁組	エングミ
縁談	エンダン
縁辺	エンペン
縄	ナワ
縄張	ナワバリ
縄張り	ナワバリ
縄暖簾	ナワノレン
縞	シマ
縦	タテ
縦列	ジュウレツ
縦横	ジュウオウ
縦横無尽	ジュウオウムジン
縦覧	ジュウラン
縦隊	ジュウタイ
縫い	ヌイ
縫いぐるみ	ヌイグルミ
縫い代	ヌイシロ
縫い物	ヌイモノ
縫い目	ヌイメ
縫田	ヌイダ
縫針	ヌイバリ
縮緬	チリメン
繁昌	ハンジョウ
繁殖	ハンショク
繊維	センイ
織田信長	オダノブナガ
繞	ニョウ
繩	ナワ
繰り言	クリゴト
繰り返	クリカエシ
繰り返し	クリカエシ
繻子	シュス
纏綿	テンメン
缶	カン
罐	カマ
罠	ワナ
罪	ツミ
罪と罰	ツミトバツ
罪人	ザイニン
罪名	ザイメイ
罪悪	ザイアク
罪滅し	ツミホロボシ
罫	ケイ
置	オキ
置き去り	オキザリ
置手紙	オキテガミ
置炬燵	オキゴタツ
罰	バチ
罰金	バッキン
署	ショ
署名	ショメイ
署長	ショチョウ
罵倒	バトウ
罵詈	バリ
羅	ラ
羅生門	ラショウモン
羅紗	ラシャ
羅織虚構	ラシキキョコウ
羅馬	ロオマ
羊	ヒツジ
羊羹	ヨウカン
美	ヨシ
美しい人	ウツクシイヒト
美事	ビジ
美人	ビジン
美味	ビミ
美妙	ビミョウ
美学	ビガク
美惠	ミエ
美感	ビカン
美挙	ビキョ
美猫	ミネコ
美男子	ビダンシ
美的	ビテキ
美術	ビジュツ
美術館	ビジュツカン
美貌	ビボウ
美質	ビシツ
美醜	ビシュウ
美青年	ビセイネン
美風	ビフウ
美麗	ビレイ
羞恥	シュウチ
群	グン
群小	グンショウ
群衆	グンシュウ
群集	グンシュウ
羨望	センボウ
義	ヨシ
義侠	ギキョウ
義兄	ギケイ
義勇	ギユウ
義務	ギム
義士	ギシ
義太夫	ギダユウ
義捐	ギエン
義捐金	ギエンキン
義理	ギリ
義理一遍	ギリイッペン
義理立て	ギリダテ
義眼	ギガン
義経	ヨシツネ
義絶	ギゼツ
義經	ヨシツネ
羽	ハネ
羽子板	ハゴイタ
羽根	ハネ
羽毛	ウモウ
羽目	ハメ
羽織	ハオリ
羽衣	ハゴロモ
羽衣伝説	ハゴロモデンセツ
羽衣石	ウイシ
翁	オウ
翌日	ヨクジツ
翌朝	ヨクアサ
習	ナライ
習い	ナライ
習性	シュウセイ
習慣	シュウカン
習癖	シュウヘキ
翕然	キュウゼン
翫	イトウ
翻弄	ホンロウ
翻訳	ホンヤク
老	ロウ
老人	ロウジン
老夫婦	ロウフウフ
老婆	ロウバ
老少不定	ロウショウフジョウ
老年	ロウネン
老木	ロウボク
老朽	ロウキュウ
老母	ロウボ
老爺	ロウヤ
老眼鏡	ロウガンキョウ
老衰	ロウスイ
考	コウ
考え	カンガエ
考え事	カンガエゴト
考え物	カンガエモノ
考え違	カンガエチガイ
考案	コウアン
考究	コウキュウ
者	モノ
者共	モノドモ
耐	ツヨシ
耳	ミミ
耳元	ミミモト
耳殻	ジカク
耳障	ミミザワリ
耶蘇	ヤソ
耶蘇教	ヤソキョウ
聖	キヨシ
聖人	セイジン
聖堂	セイドウ
聖徒	セイト
聖徳太子	ショウトクタイシ
聖書	セイショ
聖母	セイボ
聖経	キヨツネ
聞きおぼえ	キキオボエ
聞き手	キキテ
聞き方	キキカタ
聟	ムコ
聡明	ソウメイ
聯想	レンソウ
聯絡	レンラク
聯隊	レンタイ
聴手	キキテ
聴衆	チョウシュウ
聴講生	チョウコウセイ
職	ショク
職人	ショクニン
職務	ショクム
職員	ショクイン
職員室	ショクインシツ
職業	ショクギョウ
聾	ツンボ
肉	ニク
肉じゃが	ニクジャガ
肉体	ニクタイ
肉声	ニクセイ
肉太	ニクブト
肉料理	ニクリョウリ
肉筆	ニクヒツ
肉薄	ニクハク
肉親	ニクシン
肉食	ニクショク
肋骨	ロッコツ
肌	ハダ
肌身	ハダミ
肖像	ショウゾウ
肝心	カンジン
肝胆	カンタン
肝要	カンヨウ
股	マタ
股引	モモヒキ
股肱	ココウ
肥前	ヒゼン
肥大	ヒダイ
肥料	ヒリョウ
肥満	ヒマン
肩	カタ
肩に	カタニ
肩書	カタガキ
肩身	カタミ
肯定	コウテイ
肯綮	コウケイ
肱	ヒジ
肴	サカナ
肴屋	サカナヤ
肺	ハイ
肺浸潤	ハイシンジュン
肺炎	ハイエン
肺病	ハイビョウ
胃	イ
胃弱	イジャク
胃潰瘍	イカイヨウ
胃病	イビョウ
胃腸	イチョウ
胃袋	イブクロ
胆	キモ
胆力	タンリョク
背	セ
背中	セナカ
背広	セビロ
背後	ハイゴ
背戸	セド
背景	ハイケイ
背皮	セガワ
背表紙	セビョウシ
背負	セオイ
背面	ハイメン
背骨	セボネ
胎毒	タイドク
胚胎	ハイタイ
胡	エビス
胡乱	ウロン
胡坐	コザ
胡桃	クルミ
胡瓜	キュウリ
胡頽子	グミ
胡麻	ゴマ
胡麻塩	ゴマシオ
胴	ドウ
胴の間	ドウノマ
胴体	ドウタイ
胴着	ドウギ
胴間声	ドウマゴエ
胸	ムネ
胸あて	ムネアテ
胸いっぱい	ムネイッパイ
胸に一物	ムネニイチモツ
胸中	キョウチュウ
胸倉	ムナグラ
胸底	キョウテイ
胸糞	ムナクソ
能	ノウ
能力	ノウリョク
能弁	ノウベン
能率	ノウリツ
脂	アブラ
脅迫	キョウハク
脈	ミャク
脈搏	ミャクハク
脊髄	セキズイ
脚	アシ
脚本	キャクホン
脚注	キャクチュウ
脚絆	キャハン
脛	ハギ
脛に傷持つ	スネニキズモツ
脱	ダッ
脱俗	ダツゾク
脱兎	ダット
脱化	ダッカ
脱却	ダッキャク
脱稿	ダッコウ
脱線	ダッセン
脳	ノウ
脳天	ノウテン
脳溢血	ノウイッケツ
脳漿	ノウショウ
脳病院	ノウビョウイン
脳裏	ノウリ
脳裡	ノウリ
脳髄	ノウズイ
腋	ワキ
腋の下	ワキノシタ
腎臓	ジンゾウ
腐爛	フラン
腑	フ
腑抜け	フヌケ
腕	ウデ
腕まくり	ウデマクリ
腕前	ウデマエ
腕力	ワンリョク
腕時計	ウデドケイ
腕木	ウデギ
腕組	ウデグミ
腕組み	ウデグミ
腫物	ハレモノ
腰	コシ
腰つき	コシツキ
腰布	コシヌノ
腰掛	コシカケ
腰掛け	コシカケ
腰障子	コシショウジ
腸	チョウ
腹	ハラ
腹の中	ハラノウチ
腹中	フクチュウ
腹合せ	ハラアワセ
腹案	フクアン
腹膜炎	フクマクエン
腹蔵	フクゾウ
腹這	ハラバイ
腹這い	ハラバイ
腹鼓	ハラツヅミ
膃肭臍	オットセイ
膈膜	カクマク
膏	アブラ
膏薬	コウヤク
膚	ハダ
膝	ヒザ
膝元	ヒザモト
膝枕	ヒザマクラ
膝頭	ヒザガシラ
膠	ニカワ
膠着	コウチャク
膨張	ボウチョウ
膨脹	ボウチョウ
膳	ゼン
膿	ウミ
臆	オク
臆病	オクビョウ
臆病者	オクビョウモノ
臆面	オクメン
臍	ホゾ
臓物	ゾウモツ
臓腑	ゾウフ
臣	シン
臥	ガ
臥竜	ガリョウ
臨	ノゾミ
臨席	リンセキ
臨時	リンジ
臨月	リンゲツ
臨済録	リンザイロク
自ら	ミズカラ
自乗	ジジョウ
自他	ジタ
自任	ジニン
自伝	ジデン
自体	ジタイ
自信	ジシン
自刃	ジジン
自分	ジブン
自分たち	ジブンタチ
自分のために	ジブンノタメニ
自分勝手	ジブンガッテ
自分自身	ジブンジシン
自力	ジリキ
自動	ジドウ
自動車	ジドウシャ
自叙伝	ジジョデン
自国	ジコク
自在	ジザイ
自大	ジダイ
自宅	ジタク
自家	ジカ
自尊	ジソン
自尊心	ジソンシン
自己	ジコ
自席	ジセキ
自弁	ジベン
自慢	ジマン
自我	ジガ
自暴	ジボウ
自業自得	ジゴウジトク
自殺	ジサツ
自殺の方法	ジサツノホウホウ
自殺幇助罪	ジサツホウジョザイ
自治体	ジチタイ
自活	ジカツ
自炊	ジスイ
自然	シゼン
自然天然	シゼンテンネン
自然薯	ジネンジョ
自由	ジユウ
自由意志	ジユウイシ
自由自在	ジユウジザイ
自画	ジガ
自画像	ジガゾウ
自白	ジハク
自称	ジショウ
自立	ジリツ
自腹	ジバラ
自若	ジジャク
自覚	ジカク
自証	ジショウ
自認	ジニン
自説	ジセツ
自賛	ジサン
自身	ジシン
自転	ジテン
自転車	ジテンシャ
自重	ジチョウ
臭	ニオイ
臭い	クサイ
臭気	シュウキ
至	イタリ
至り	イタリ
至境	シキョウ
至当	シトウ
至情	シジョウ
至極	シゴク
至誠	シセイ
至難	シナン
至高	シコウ
致	イタル
致し方	イタシカタ
致死量	チシリョウ
臼	ウス
舅	シュウト
興	キョウ
興人	コウジン
興味	キョウミ
興奮	コウフン
興奮剤	コウフンザイ
興行	コウギョウ
興覚	オキサト
興趣	キョウシュ
舌	シタ
舌頭	ゼットウ
舞	マイ
舞台	ブタイ
舞踏	ブトウ
舞踏会	ブトウカイ
舟	フネ
舳	ヘ
舶来	ハクライ
船	フネ
船で	フナデ
船中	フナナカ
船乗り	フナノリ
船橋市	フナバシシ
船端	フナバタ
船縁	フナベリ
船舶	センパク
船頭	センドウ
艀	ハシケ
艘	ソウ
艫	トモ
良	リョウ
良人	リョウジン
良友	リョウユウ
良夜	リョウヤ
良家	リョウケ
良心	リョウシン
良方	リョウホウ
良民	リョウミン
良縁	リョウエン
良薬	リョウヤク
艱苦	カンク
色	イロ
色々	イロイロ
色えんぴつ	イロエンピツ
色つや	イロツヤ
色好み	イロゴノミ
色彩	シキサイ
色気	イロケ
色男	イロオトコ
色盲	シキモウ
色紙	イロガミ
色鉛筆	イロエンピツ
色魔	シキマ
艶	ツヤ
艶美	ツヤミ
艶聞	エンブン
芋	イモ
芍薬	シャクヤク
芝	シバ
芝居	シバイ
芝居気	シバイギ
芝生	シバフ
芝草	シバクサ
芥子	カラシ
芥子菜	カラシナ
芥川龍之介	アクタガワリュウノスケ
芭蕉	バショウ
芭蕉葉	バショウバ
花	ハナ
花の都	ハナノミヤコ
花びら	ハナビラ
花やか	ハナヤカ
花吹雪	ハナフブキ
花嫁	ハナヨメ
花屋敷	ハナヤシキ
花崗	ミカゲ
花川戸	ハナカワド
花弁	ハナビラ
花形	ハナガタ
花文字	ハナモジ
花曇り	ハナグモリ
花月	カゲツ
花椒	ホアジャオ
花水木	ハナミズキ
花活	ハナイケ
花活け	ハナイケ
花火	ハナビ
花瓶	カビン
花粉	カフン
花粉症	カフンショウ
花聟	ハナムコ
花見	ハナミ
花言葉	ハナコトバ
花道	カドウ
花開	ハナカイ
花魁	オイラン
花鳥	カチョウ
芳原	ヨシハラ
芳秋	ヨシアキ
芳香	ホウコウ
芸	ゲイ
芸人	ゲイニン
芸当	ゲイトウ
芸者	ゲイシャ
芸術	ゲイジュツ
芸術家	ゲイジュツカ
芸術的	ゲイジュツテキ
芹	セリ
芽	メ
芽生	メム
芽生え	メバエ
苔桃	コケモモ
苗	ナエ
苗字	ミョウジ
苞	ツト
若い	ワカイ
若い人	ワカイヒト
若い女	ワカイオンナ
若い者	ワカイモノ
若い衆	ワカイシュ
若さ	ワカサ
若人	ワコウド
若僧	ワカゾウ
若干	ジャッカン
若旦那	ワカダンナ
若白髪	ワカシラガ
若竹	ワカタケ
若菜	ワカナ
若葉	ワカバ
若造	ワカゾウ
苦	ク
苦い経験	ニガイケイケン
苦しまぎれ	クルシマギレ
苦しみ	クルシミ
苦し紛れ	クルシマギレ
苦労	クロウ
苦労人	クロウニン
苦味	ニガミ
苦心	クシン
苦心惨憺	クシンサンタン
苦悩	クノウ
苦悶	クモン
苦情	クジョウ
苦手	ニガテ
苦痛	クツウ
苦笑	クショウ
苦笑い	ニガワライ
苦難	クナン
英	エイ
英司	エイジ
英吉利	イギリス
英名	エイメイ
英国	エイコク
英姿颯爽	エイシサッソウ
英文	エイブン
英語	エイゴ
英語名	エイゴメイ
英雄	エイユウ
苹果	リンゴ
苺	イチゴ
茂	シゲル
茂み	シゲミ
茂作	シゲサク
茄子	ナスビ
茅屋	ボウオク
茎	クキ
茎立	ククタチ
茎菜類	ケイサイルイ
茗荷	ミョウガ
茫々	ボウボウ
茫漠	ボウバク
茫然	ボウゼン
茱萸	グミ
茶	チャ
茶々	チャチャ
茶いろ	チャイロ
茶の木	チャノキ
茶の間	チャノマ
茶人	チャジン
茶代	チャダイ
茶園	チャエン
茶屋	チャヤ
茶店	チャミセ
茶托	チャタク
茶漬	チャヅケ
茶畠	チャバタケ
茶番	チャバン
茶碗	チャワン
茶碗の中	チャワンノナカ
茶筌	チャセン
茶箪笥	チャダンス
茶色	チャイロ
茶褐色	チャカッショク
茸	タケ
草	クサ
草々	ソウソウ
草原	ソウゲン
草双紙	クサゾウシ
草履	ゾウリ
草履取り	ゾウリトリ
草書	ソウショ
草稿	ソウコウ
草臥儲	クタビレモウケ
草花	クサバナ
草餅	クサモチ
荒涼	コウリョウ
荒磯	アリソ
荒肝	アラギモ
荘厳	ショウゴン
荷	ニ
荷作り	ニヅクリ
荷厄介	ニヤッカイ
荷物	ニモツ
荷車	ニグルマ
莫大	バクダイ
菅原道真	スガワラノミチザネ
菅笠	スゲガサ
菊坂	キクサカ
菌	キン
菓子	カシ
菓子折	カシオリ
菜	サイ
菜っ葉	ナッパ
菜の花	ナノハナ
菜園	サイエン
菜種油	ナタネアブラ
菜飯	ナメシ
菩提所	ボダイショ
菫	スミレ
華	ハナ
華厳の滝	ケゴンノタキ
華厳滝	ケゴンノタキ
華奢	キャシャ
華山	カザン
華族	カゾク
菱形	ヒシガタ
菴	イホリ
萌	モエ
萌芽	ホウガ
萎縮	イシュク
萩野	ハギノ
落	オチ
落し	オトシ
落ち	オチ
落ちつき	オチツキ
落下	ラッカ
落人	オチウド
落付	オチツキ
落城	ラクジョウ
落度	オチド
落日	ラクジツ
落款	ラッカン
落着	ラクチャク
落第	ラクダイ
落葉	ラクヨウ
落語	ラクゴ
落雁	ラクガン
葉	ハ
葉巻	ハマキ
葉桜	ハザクラ
葉菜類	ヨウサイルイ
葉蘭	ハラン
著	シル
著名	チョメイ
著書	チョショ
著述	チョジュツ
葛根湯	カッコントウ
葛練り	クズネリ
葛藤	カットウ
葡萄	ブドウ
葬	ホウム
葬式	ソウシキ
葭簀	ヨシズ
葱	ネギ
葵	アオイ
蒔絵	マキエ
蒙昧	モウマイ
蒟蒻	コンニャク
蒟蒻問答	コンニャクモンドウ
蒟蒻版	コンニャクバン
蒲	カバ
蒲公英	ホコウエイ
蒲原郡	カンバラグン
蒲団	フトン
蒲鉾	カマボコ
蒸	ムシ
蒸気	ジョウキ
蒸溜	ジョウリュウ
蒸発	ジョウハツ
蒸籠	セイロ
蒼	アオイ
蒼天	ソウテン
蒼生	ソウセイ
蒼蠅	クロバエ
蓄積	チクセキ
蓆	ムシロ
蓋	フタ
蓙	ゴザ
蓬	ヨモギ
蓬莱町	ホウライチョウ
蓮	ハチス
蓮の葉	ハスノハ
蓮根	レンコン
蓮池	ハスイケ
蓮生	ハスオ
蓼	タデ
蔑視	ベッシ
蔓	ツル
蔓延	マンエン
蔦	ツタ
蔭	カゲ
蔵	クラ
蕎麦	ソバ
蕎麦屋	ソバヤ
蕎麦湯	ソバユ
蕎麦粉	ソバコ
蕗	フキ
蕨	ワラビ
蕩々	トウトウ
蕪	カブラ
蕪村	ブソン
薄	ススキ
薄い本	ウスイホン
薄っぺら	ウスッペラ
薄もの	ウスモノ
薄化粧	ウスゲショウ
薄志弱行	ハクシジャッコウ
薄氷	ハクヒョウ
薄紫	ウスムラサキ
薄馬鹿	ウスバカ
薔薇	バラ
薙刀	ナギナタ
薨去	コウキョ
薩摩	サツマ
薩摩上布	サツマジョウフ
薩摩下駄	サツマゲタ
薩摩絣	サツマガスリ
薩摩芋	サツマイモ
薪	タキギ
薫	カオル
薫陶	クントウ
薬	クスリ
薬事法	ヤクジホウ
薬代	クスリダイ
薬剤師	ヤクザイシ
薬味	ヤクミ
薬品	ヤクヒン
薬屋	クスリヤ
薬師町	ヤクシチョウ
薬湯	ヤクトウ
薬物療法	ヤクブツリョウホウ
薬王	ヤクオ
薬礼	ヤクレイ
薬缶	ヤカン
薯	イモ
薺	ナズナ
藁	ワラ
藁しべ	ワラシベ
藁葺	ワラブキ
藍	アイ
藤	フジ
藤十郎	トウジュウロウ
藤原	フジワラ
藤原泰衡	フジワラノヤスヒラ
藤村	フジムラ
藤間	トウマ
藪	ヤブ
藪の中	ヤブノナカ
藻	モ
蘇生	ソセイ
蘭	ラン
虎	トラ
虎の尾を踏む	トラノオヲフム
虎の巻	トラノマキ
虎蔵	トラゾウ
虐待	ギャクタイ
虔	ケン
虚	ウロ
虚仮	コケ
虚偽	キョギ
虚勢	キョセイ
虚子	キョシ
虚栄	キョエイ
虚構	キョコウ
虚言	キョゲン
虞	オソレ
虫	ムシ
虫めがね	ムシメガネ
虱	シラミ
虹	ニジ
虻	アブ
蚊	カ
蚊帳	カヤ
蚕	カイコ
蚕食	サンショク
蚤	ノミ
蚯蚓	ミミズ
蛇	ヘビ
蛇の目	ジャノメ
蛇矛	ダボウ
蛇蝎のごとく	ダカツノゴトク
蛇足	ダソク
蛍	ホタル
蛍光ペン	ケイコウペン
蛍烏賊	ホタルイカ
蛙	カエル
蛮声	バンセイ
蛮風	バンプウ
蛸壺	タコツボ
蜂	ハチ
蜂の巣	ハチノス
蜘蛛の巣	クモノス
蜜	ミツ
蜜柑	ミカン
蜜豆	ミツマメ
蝉	セミ
蝋	ロウ
蝋燭	ロウソク
蝎	サソリ
蝗	イナゴ
蝙蝠	コウモリ
蝙蝠傘	コウモリガサ
蝦	エビ
蝦夷	エゾ
蝦蟇口	ガマグチ
蝨	シラミ
蝸牛	カギュウ
融合	ユウゴウ
融和	ユウワ
融通	ユウズウ
螺旋	ラセン
蟄居	チッキョ
蟆	ガマ
蟇	ヒキガエル
蟋蟀	コオロギ
蟒	ウワバミ
蟷螂	カマキリ
蟹	カニ
蟻	アリ
蟾蜍	ヒキガエル
蠅	ハエ
蠍座	サソリザ
蠕動	ゼンドウ
蠢動	シュンドウ
蠧紙堆裏	トシタイリ
血	チ
血の道	チノミチ
血気	ケッキ
血液	ケツエキ
血潮	チシオ
血痰	ケッタン
血管	ケッカン
血肉	ケツニク
血脈	ケチミャク
衆	シュウ
衆人環座	シュウジンカンザ
衆目環視	シュウモクカンシ
行	クダリ
行かないで	イカナイデ
行かん	イカン
行き	イキ
行きすぎ	イキスギ
行きたくない	イキタクナイ
行き倒れ	ユキダオレ
行き帰り	ユキカエリ
行き当り	イキアタリ
行き当りばったり	ユキアタリバッタリ
行き掛り	ユキガカリ
行く先	ユクサキ
行こう	イコウ
行住坐臥	ギョウジュウザガ
行儀	ギョウギ
行先	ユクサキ
行列	ギョウレツ
行動	コウドウ
行司	ギョウジ
行商	ギョウショウ
行幸	ギョウコウ
行徳	ギョウトク
行手	ユクテ
行掛	ユキガケ
行方	ユクエ
行末	ユクスエ
行李	コウリ
行水	ギョウズイ
行灯袴	アンドンバカマ
行為	コウイ
行路	コウロ
行進	コウシン
行雲流水	コウウンリュウスイ
術	ジュツ
術中	ジュッチュウ
術数	ジュッスウ
術語	ジュツゴ
街	マチ
街道	カイドウ
衛生	エイセイ
衛門	エモン
衝動	ショウドウ
衝突	ショウトツ
衣	コロモ
衣川	キヌガワ
衣服	イフク
衣紋	エモン
衣装	イショウ
衣類	イルイ
衣食	イショク
衣食住	イショクジュウ
表	ヒョウ
表し	ヒョウシ
表向	オモテムキ
表向き	オモテムキ
表情	ヒョウジョウ
表明	ヒョウメイ
表沙汰	オモテザタ
表現	ヒョウゲン
表皮	ヒョウヒ
表示	ヒョウジ
表章	オモテアキラ
表紙	ヒョウシ
表裏	ヒョウリ
表記	ヒョウキ
表通り	オモテドオリ
表門	オモテモン
表面	ヒョウメン
表題	ヒョウダイ
衰弱	スイジャク
衰微	スイビ
衰退	スイタイ
衲	ノト
袂	タモト
袋	フクロ
袋戸	フクロド
袖	ソデ
袖の下	ソデノシタ
袖口	ソデグチ
被子植物	ヒシショクブツ
被害	ヒガイ
袱紗	フクサ
袴	ハカマ
袷	アワセ
裁判	サイバン
裁判官	サイバンカン
裁判所	サイバンショ
裁縫	サイホウ
装	ソウ
装置	ソウチ
装飾	ソウショク
裏	ウラ
裏がえし	ウラガエシ
裏側	ウラガワ
裏切	ウラギリ
裏切り	ウラギリ
裏切者	ウラギリモノ
裏口	ウラグチ
裏店	ウラダナ
裏手	ウラテ
裏書	ウラガキ
裏町	ウラマチ
裏表	ウラオモテ
裏返し	ウラガエシ
裏面	リメン
裕福	ユウフク
補助	ホジョ
裡	ウラ
裳	モ
裸	ハダカ
裸体	ラタイ
裸婦	ラフ
裸足	ハダシ
製	セイ
製作	セイサク
製作物	セイサクブツ
製塩	セイエン
製本	セイホン
製造	セイゾウ
製造元	セイゾウモト
裾	スソ
裾模様	スソモヨウ
複数	フクスウ
複雑	フクザツ
褐色	カッショク
褒美	ホウビ
襖	フスマ
襟	エリ
襟飾り	エリカザリ
襟髪	エリガミ
襦袢	ジバン
襲撃	シュウゲキ
西	ニシ
西側	ニシガワ
西南戦争	セイナンセンソウ
西向き	ニシムキ
西川	ニシカワ
西日	ニシビ
西江	ニシエ
西洋	セイヨウ
西洋なし	セイヨウナシ
西洋人	セイヨウジン
西洋料理	セイヨウリョウリ
西洋館	セイヨウカン
西行	サイギョウ
西郷隆盛	サイゴウタカモリ
要件	ヨウケン
要塞	ヨウサイ
要心	ヨウジン
要撃	ヨウゲキ
要求	ヨウキュウ
要点	ヨウテン
要素	ヨウソ
要領	ヨウリョウ
見え	ミエ
見ず知らず	ミズシラズ
見はり	ミハリ
見まい	ミマイ
見め	ミメ
見わけ	ミワケ
見世物	ミセモノ
見事	ミゴト
見出し	ミダシ
見分け	ミワケ
見合	ミアイ
見地	ケンチ
見境	ミサカイ
見学	ケンガク
見幕	ケンマク
見張り	ミハリ
見当	ケントウ
見性成仏	ケンショウジョウブツ
見性自覚	ケンショウジカク
見掛け	ミカケ
見栄	ミエ
見栄坊	ミエボウ
見極め	ミキワメ
見様見真似	ミヨウミマネ
見殺し	ミゴロシ
見物	ケンブツ
見物人	ケンブツニン
見番	ケンバン
見直し	ミナオシ
見知り	ミシリ
見聞	ケンブン
見舞	ミマイ
見舞い	ミマイ
見覚え	ミオボエ
見解	ケンカイ
見識	ケンシキ
見込	ミコミ
見込み	ミコミ
見送り	ミオクリ
見附	ミツケ
規則	キソク
規律	キリツ
規約	キヤク
視	ミ
視力	シリョク
視察	シサツ
視線	シセン
視聴	シチョウ
視覚	シカク
覗	ノゾキ
覗き	ノゾキ
覗き見	ノゾキミ
覚	サトシ
覚え	オボエ
覚悟	カクゴ
覚禅	カクゼン
覚醒	カクセイ
覧	ラン
親	オヤ
親しみ	シタシミ
親たち	オヤタチ
親の敵	オヤノカタキ
親不孝	オヤフコウ
親切	シンセツ
親切心	シンセツシン
親友	シンユウ
親和	シンワ
親子	オヤコ
親子丼	オヤコドン
親子連	オヤコヅレ
親孝行	オヤコウコウ
親密	シンミツ
親愛	シンアイ
親戚	シンセキ
親指	オヤユビ
親方	オヤカタ
親本	オヤモト
親父	オヤジ
親爺	オヤジ
親譲り	オヤユズリ
親身	シンミ
親類	シンルイ
親鸞	シンラン
観	カン
観察	カンサツ
観念	カンネン
観測所	カンソクショ
観点	カンテン
観音	カンノン
観音堂	カンノンドウ
角	カク
角地	カドチ
角屋	カクヤ
角屋敷	カドヤシキ
角度	カクド
角砂糖	カクザトウ
解	カイ
解れつ	カイレツ
解剖	カイボウ
解放	カイホウ
解決	カイケツ
解脱	ゲダツ
解説	カイセツ
解釈	カイシャク
触れ	フレ
言	ゲン
言いぶん	イイブン
言いよう	イイヨウ
言い伝え	イイツタエ
言い方	イイカタ
言い知れぬ	イイシレヌ
言い草	イイグサ
言えばよかった	イエバヨカッタ
言下	ゲンカ
言下に	ゲンカニ
言伝え	イイツタエ
言動	ゲンドウ
言句	ゴンク
言文一致	ゲンブンイッチ
言葉	コトバ
言葉づかい	コトバヅカイ
言葉通り	コトバドオリ
言葉遣い	コトバヅカイ
言行	ゲンコウ
言訳	イイワケ
言語	ゲンゴ
言語道断	ゴンゴドウダン
言辞	ゲンジ
訂正	テイセイ
計	ケイ
計画	ケイカク
計略	ケイリャク
計算	ケイサン
訊問	ジンモン
訓	クン
訓戒	クンカイ
訓練	クンレン
記	キ
記事	キジ
記入	キニュウ
記号	キゴウ
記念	キネン
記憶	キオク
記者	キシャ
記述	キジュツ
記録	キロク
訛り	ナマリ
訣別	ケツベツ
訪問	ホウモン
訪問者	ホウモンシャ
設備	セツビ
設定	セッテイ
設立	セツリツ
許	モト
許可	キョカ
許嫁	イイナズケ
許諾	キョダク
訳	ワケ
訳合	ワケアイ
訴え	ウッタエ
訴訟	ソショウ
診察	シンサツ
診断	シンダン
診断書	シンダンショ
註釈	チュウシャク
証券	ショウケン
証拠	ショウコ
証明	ショウメイ
証明書	ショウメイショ
証書	ショウショ
詐り	イツワリ
詐偽	サギ
詐欺	サギ
詐欺師	サギシ
詐欺罪	サギザイ
評	ヒョウ
評価	ヒョウカ
評判	ヒョウバン
評論	ヒョウロン
詞	コトバ
試し	タメシ
試み	ココロミ
試験	シケン
詩	シ
詩人	シジン
詩句	シク
詩吟	シギン
詩文	シブン
詩歌	シカ
詩歌管弦	シイカカンゲン
詩的	シテキ
詩集	シシュウ
詫	ツゲ
詫び	ワビ
詮	セン
詰	ツメ
詰まり	ツマリ
詰め	ツメ
詰問	キツモン
詰腹	ツメバラ
詰責	キッセキ
話	ハナシ
話して	ハナシテ
話しゃ	ワシャ
話し声	ハナシゴエ
話し相手	ハナシアイテ
話頭	ワトウ
話題	ワダイ
詳細	ショウサイ
誂	アツラエ
誅戮	チュウリク
誇り	ホコリ
誇大	コダイ
誇張	コチョウ
誉	ホマレ
認	ミトム
認定	ニンテイ
認識	ニンシキ
誕生	タンジョウ
誕生寺	タンジョウジ
誘い	サソイ
誘因	ユウイン
誘導	ユウドウ
誘惑	ユウワク
誘致	ユウチ
語	カタリ
語き	ゴキ
語く	ゴク
語り物	カタリモノ
語勢	ゴセイ
語学	ゴガク
語尾	ゴビ
語弊	ゴヘイ
語彙	ゴイ
語気	ゴキ
語源	ゴゲン
誠之	セイシ
誠実	セイジツ
誠意	セイイ
誤り	アヤマリ
誤植	ゴショク
誤用	ゴヨウ
誤解	ゴカイ
誤謬	ゴビュウ
説	セツ
説得	セットク
説教	セッキョウ
説明	セツメイ
説法	セッポウ
説話	セツワ
説諭	セツユ
読	サトル
読み	ヨミ
読み手	ヨミテ
読み方	ヨミカタ
読み書き	ヨミカキ
読み物	ヨミモノ
読売新聞	ヨミウリシンブン
読心術	ドクシンジュツ
読書	ドクショ
読書会	ドクショカイ
読書家	ドクショカ
読本	ドクホン
読者	ドクシャ
読誦	ドクジュ
誰	ダレ
誰か	ダレカ
誰かれ	ダレカレ
誰だ	ダレダ
誰も知らない	ダレモシラナイ
誰何	スイカ
誰彼	ダレカレ
課業	カギョウ
誹謗	ヒボウ
調	チョウ
調べ	シラベ
調停	チョウテイ
調和	チョウワ
調子	チョウシ
調査	チョウサ
調練	チョウレン
調達	チョウタツ
談	ダン
談判	ダンパン
談笑	ダンショウ
談話	ダンワ
談議	ダンギ
請書	ウケショ
請求	セイキュウ
諒	リョウ
諒察	リョウサツ
論	ロン
論より証拠	ロンヨリショウコ
論及	ロンキュウ
論定	ロンテイ
論拠	ロンキョ
論文	ロンブン
論断	ロンダン
論法	ロンポウ
論点	ロンテン
論理	ロンリ
論理学	ロンリガク
論理的	ロンリテキ
論証	ロンショウ
論語	ロンゴ
諦	タイ
諷刺	フウシ
諸	ショ
諸侯	ショコウ
諸君	ショクン
諸家	ショカ
諸方	ショホウ
諺	コトワザ
諾々	ダクダク
諾否	ダクヒ
謀叛	ムホン
謎	ナゾ
謙譲語	ケンジョウゴ
謙遜	ケンソン
講師	コウシ
講筵	コウエン
講義	コウギ
講話	コウワ
講談	コウダン
講釈	コウシャク
講釈師	コウシャクシ
謝	シャ
謝罪	シャザイ
謡	ウタイ
謡曲	ヨウキョク
謬見	ビュウケン
謹直	キンチョク
謹聴	キンチョウ
識別	シキベツ
譚	タン
譜	フ
警	ケイ
警備	ケイビ
警句	ケイク
警告	ケイコク
警察	ケイサツ
警察官	ケイサツカン
警戒	ケイカイ
警視庁	ケイシチョウ
議会	ギカイ
議員	ギイン
議論	ギロン
譴責	ケンセキ
護	マモル
護謨	ゴム
護身	ゴシン
讃	サン
讃美歌	イチ
讒訴	ザンソ
谷	タニ
谷あい	タニアイ
豁然	カツゼン
豆	マメ
豆乳鍋	トウニュウナベ
豆板醤	トウバンジャン
豆腐	トウフ
豆腐ステーキ	トウフステーキ
豊か	ユタカ
豊富	ホウフ
豊水	ホウスイ
豊穣	ホウジョウ
豌豆	エンドウ
豎子	ジュシ
豚	ブタ
豚丼	トンドン
豚汁	トンジル
豚肉	ブタニク
象	ゾウ
象徴	ショウチョウ
象徴詩	ショウチョウシ
象牙	ゾウゲ
豪	ゴウ
豪傑	ゴウケツ
豪奢	ゴウシャ
豪気	ゴウキ
豪胆	ゴウタン
豪華	ゴウカ
豹変	ヒョウヘン
貝	カイ
貝がら	カイガラ
貝割れ菜	カイワレナ
貝殻	カイガラ
貞婦	テイフ
貞操観念	テイソウカンネン
負け	マケ
負けん気	マケンキ
負け嫌い	マケギライ
負け惜しみ	マケオシミ
負傷	フショウ
負惜み	マケオシミ
負担	フタン
財宝	ザイホウ
財布	サイフ
財産	ザイサン
貧	ヒン
貧乏	ビンボウ
貧乏人	ビンボウニン
貧乏性	ビンボウショウ
貧富	ヒンプ
貧弱	ヒンジャク
貧民	ヒンミン
販売	ハンバイ
貪婪	ドンラン
貫	ヌキ
責	セメ
責め	セメ
責任	セキニン
責任者	セキニンシャ
貯蓄	チョチク
貯蔵	チョゾウ
貯金	チョキン
貰	モライ
貰い	モライ
貰い手	モライテ
貴人	キジン
貴女	キジョ
貴婦人	キフジン
貴家	キカ
貴方	アナタ
貴様	キサマ
貴賤老若	キセンロウニャク
貴重	キチョウ
買	ガイ
買いつけ	カイツケ
買い出し	カイダシ
買い物	カイモノ
買収	バイシュウ
買物	カイモノ
貸し	カシ
貸して	カシテ
貸家	カシヤ
貸費	タイヒ
費	ヒ
費用	ヒヨウ
賃	チン
賄	マカナイ
賄賂	ワイロ
資	シ
資本	シホン
資格	シカク
資産	シサン
資金	シキン
賑	ニギワイ
賑やか	ニギヤカ
賓	ヒン
賛	サン
賛助	サンジョ
賛同	サンドウ
賛成	サンセイ
賜物	タマモノ
賞	ショウ
賞与	ショウヨ
賞賛	ショウサン
賢	ケン
賢人	ケンジン
賢哲	ケンテツ
賢夫人	ケンプジン
賢者	ケンジャ
賤業	センギョウ
賦	フ
質	シツ
質入	シチイレ
質問	シツモン
質屋	シチヤ
質朴	シツボク
質朴剛健	シツボクゴウケン
質素	シッソ
質草	シチグサ
賭	ト
購入	コウニュウ
購求	コウキュウ
贅沢	ゼイタク
贅物	ゼイブツ
贈り物	オクリモノ
贋	ニセ
贋札	ニセサツ
贋物	ニセモノ
贋造	ガンゾウ
贔屓	ヒイキ
赤	アカ
赤い舌	アカイシタ
赤ひげ	アカヒゲ
赤ん坊	アカンボウ
赤シャツ	アカシャツ
赤十字	セキジュウジ
赤土	アカツチ
赤地	アカジ
赤坂	アカサカ
赤帽	アカボウ
赤恥	アカハジ
赤旗	アカハタ
赤本	アカホン
赤松	アカマツ
赤毛	アカゲ
赤蛙	アカガエル
赤裸	アカハダカ
赤銅	シャクドウ
赤面	セキメン
走り	ハシリ
走馬燈	ソウマトウ
赴任	フニン
起き抜け	オキヌケ
起し	オコシ
起り	オコリ
起因	キイン
起居	キキョ
起源	キゲン
起立	キリツ
起臥	キガ
起訴	キソ
起訴猶予	キソユウヨ
超人	チョウジン
超凡	チョウボン
超然	チョウゼン
超然主義	チョウゼンシュギ
超絶	チョウゼツ
超邁	チョウマイ
越	コシ
越し	コシ
越中褌	エッチュウフンドシ
越後	エチゴ
越後獅子	エチゴジシ
越智	オチ
趣	オモムキ
趣向	シュコウ
趣味	シュミ
趨勢	スウセイ
足	アシ
足ぶみ	アシブミ
足へん	アシヘン
足もと	アシモト
足並	アシナミ
足元	アシモト
足前	タシマエ
足拍子	アシビョウシ
足搦	アシガラミ
足袋	タビ
足跡	アシアト
足踏	アシブミ
足踏み	アシブミ
足音	アシオト
足駄	アシダ
跛	チンバ
距離	キョリ
跡	アト
跡形	アトカタ
跣足	ハダシ
路	ミチ
路傍	ロボウ
路次	ロジ
路頭	ロトウ
跳	チョウ
跳ね	ハネ
跳返	ハネカエリ
跳返り	ハネカエリ
踊	オドリ
踊り	オドリ
踏切り	フミキリ
踏破	トウハ
踵	カカト
蹄	ヒズメ
蹣跚	マンサン
蹲	ツクバイ
蹲踞	ソンキョ
蹴合い	ケアイ
躁狂	ソウキョウ
躄	イザリ
躊躇	チュウチョ
躍起	ヤッキ
躑躅	ツツジ
身	ミ
身のまわり	ミノマワリ
身の丈	ミノタケ
身の上	ミノウエ
身の毛	ミノケ
身上	シンジョウ
身代	シンダイ
身代り	ミガワリ
身体	シンタイ
身元	ミモト
身内	ミウチ
身分	ミブン
身動き	ミウゴキ
身悶え	ミモダエ
身投げ	ミナゲ
身振	ミブリ
身振り	ミブリ
身構	ミガマエ
身辺	シンペン
身長	シンチョウ
身震い	ミブルイ
躾	シツケ
車	クルマ
車内	シャナイ
車力	シャリキ
車夫	シャフ
車屋	クルマヤ
車引	クルマヒキ
車持皇子	クラモチノミコ
車掌	シャショウ
車輪	シャリン
軍	グン
軍人	グンジン
軍力	グンリョク
軍勢	グンゼイ
軍国	グンコク
軍師	グンシ
軍服	グンプク
軍歌	グンカ
軍略	グンリャク
軍部	グンブ
軍配	グンバイ
軍隊	グンタイ
軍鶏	シャモ
軒	ノキ
軒下	ノキシタ
軒先	ノキサキ
軒端	ノキバ
軟らか	ヤワラカ
軟化	ナンカ
転	テン
転てつ機	テンテツキ
転任	テンニン
転倒	テントウ
転化	テンカ
転地	テンチ
転地療養	テンチリョウヨウ
転換	テンカン
転用	テンヨウ
転落	テンラク
転送	テンソウ
軽はずみ	カルハズミ
軽侮	ケイブ
軽便信用	ケイベンシンヨウ
軽便鉄道	ケイベンテツドウ
軽口を叩く	カルクチヲタタク
軽少	ケイショウ
軽微	ケイビ
軽率	ケイソツ
軽症	ケイショウ
軽石	カルイシ
軽蔑	ケイベツ
軽薄	ケイハク
軽躁	ケイソウ
軽重	ケイチョウ
輓近	バンキン
輝	テル
輩	トモガラ
輪	ワ
輪ゴム	ワゴム
輪廓	リンカク
輪廻	リンネ
輪転	リンテン
輸入	ユニュウ
輸贏	ユエイ
輻	ヤ
輿入	コシイレ
辛	カラシ
辛抱	シンボウ
辛苦	シンク
辞	ジ
辞令	ジレイ
辞儀	ジギ
辞典	ジテン
辞職	ジショク
辞職勧告	ジショクカンコク
辞表	ジヒョウ
辞退	ジタイ
辟易	ヘキエキ
辰	タツ
農作物	ノウサクモツ
農学書	ノウガクショ
農業	ノウギョウ
農耕	ノウコウ
辺	アタリ
辺り	アタリ
辺鄙	ヘンピ
辻	ツジ
辻褄	ツジツマ
辻風	ツジカゼ
込	コミ
込み	コミ
迂回	ウカイ
迂遠	ウエン
迂闊	ウカツ
迅速	ジンソク
迎	ムカイ
迎い	ムカイ
迎合	ゲイゴウ
近く	チカク
近付	チカヅキ
近付き	チカヅキ
近年	キンネン
近所	キンジョ
近所合壁	キンジョガッペキ
近日	キンジツ
近来	キンライ
近松	チカマツ
近江	オウミ
近江屋	オオミヤ
近火	キンカ
近眼	キンガン
近辺	キンペン
近道	チカミチ
近頃	チカゴロ
返うち	カエリウチ
返事	ヘンジ
返却	ヘンキャク
返報	ヘンポウ
返書	ヘンショ
返歌	ヘンカ
返礼	ヘンレイ
返答	ヘントウ
返電	ヘンデン
迫害	ハクガイ
述懐	ジュッカイ
迷	メイ
迷い	マヨイ
迷乱	メイラン
迷亭	メイテイ
迷信	メイシン
迷子	マイゴ
迷惑	メイワク
迷惑千万	メイワクセンバン
迸出	ヘイシュツ
追って	オッテ
追加	ツイカ
追及	ツイキュウ
追憶	ツイオク
追懐	ツイカイ
追手	オッテ
追放	ツイホウ
追窮	ツイキュウ
退却	タイキャク
退去	タイキョ
退学	タイガク
退屈	タイクツ
退校	タイコウ
退治	タイジ
送り	オクリ
送別	ソウベツ
送別会	ソウベツカイ
送籍	ソウセキ
送金	ソウキン
逃げ	ニゲ
逃亡	トウボウ
逃道	ニゲミチ
逆	ギャク
逆さ	サカサ
逆さま	サカサマ
逆上	ギャクジョウ
逆戻り	ギャクモドリ
逆捩	サカネジ
逆茂木	サカモギ
逆襲	ギャクシュウ
逆鱗	ゲキリン
逍遥	ショウヨウ
透	トオル
透き	スキ
透明	トウメイ
透綾	スキヤ
途	ト
途中	トチュウ
途方	トホウ
途端	トタン
逗留	トウリュウ
通	ツウ
通し	トオシ
通じ	ツウジ
通せ	トオリセ
通らん	ツウラン
通り	トオリ
通りま	トオリマ
通人	ツウジン
通例	ツウレイ
通俗	ツウゾク
通俗的	ツウゾクテキ
通信	ツウシン
通信簿	ツウシンボ
通則	ツウソク
通常	ツウジョウ
通弁	ツウベン
通暁	ツウギョウ
通用	ツウヨウ
通町	トオリマチ
通知	ツウチ
通称	ツウショウ
通行	ツウコウ
通行券	ツウコウケン
通路	ツウロ
通過	ツウカ
速	ハヤ
速さ	ハヤサ
速力	ソクリョク
速度	ソクド
速断	ソクダン
造	ミヤツコ
造り	ツクリ
造作	ゾウサク
造作もない	ゾウサモナイ
造血	ゾウケツ
造詣	ゾウケイ
逡巡	シュンジュン
逢着	ホウチャク
連	レン
連れ	ツレ
連中	レンチュウ
連判状	レンバンジョウ
連夜	レンヤ
連想	レンソウ
連戦連勝	レンセンレンショウ
連発	レンパツ
連結	レンケツ
連絡	レンラク
連続	レンゾク
連綿	レンメン
連署	レンショ
連載漫画	レンサイマンガ
週	シュウ
週間	シュウカン
進上	シンジョウ
進化	シンカ
進化論	シンカロン
進取	シンシュ
進呈	シンテイ
進展	シンテン
進捗	シンチョク
進歩	シンポ
進級	シンキュウ
進行	シンコウ
逸事	イツジ
逸出	イッシュツ
逸品	イッピン
逸楽	イツラク
逸民	イツミン
逸話	イツワ
遁	トン
遂行	スイコウ
遅れ	オクレ
遅刻	チコク
遅速	チソク
遇	グウ
遊び	アソビ
遊び半分	アソビハンブン
遊び友達	アソビトモダチ
遊園地	ユウエンチ
遊子	ユウシ
遊廓	ユウカク
遊弋	ユウヨク
遊戯	ユウギ
遊戯三昧	ユゲザンマイ
遊技	ユウギ
遊興	ユウキョウ
遊離	ユウリ
運	ウン
運び	ハコビ
運動	ウンドウ
運動場	ウンドウジョウウンドウバ
運命	ウンメイ
運営	ウンエイ
運筆	ウンピツ
運行	ウンコウ
運転	ウンテン
遍	アマネ
過ぎ	スギ
過分	カブン
過半	カハン
過去	カコ
過失	カシツ
過度	カド
過敏	カビン
過激	カゲキ
過程	カテイ
過言	カゴン
道	ミチ
道々	ドウドウ
道づれ	ミチヅレ
道ばた	ミチバタ
道中	ドウチュウ
道中双六	ドウチュウスゴロク
道具	ドウグ
道具屋	ドウグヤ
道具立て	ドウグダテ
道化	ドウケ
道化師	ドウケシ
道化者	ドウケモノ
道場	ドウジョウ
道学	ドウガク
道家	ミチヤ
道幅	ミチハバ
道徳	ドウトク
道徳経	ドウトクキョウ
道楽	ドウラク
道歌	ドウカ
道理	ドウリ
道破	ドウハ
道路	ドウロ
達	イタル
達磨	ダルマ
達者	タッシャ
達観	タッカン
違	チガイ
違い	チガイ
違い棚	チガイダナ
遠く	トオク
遠く遠く	トオクトオク
遠で	トオデ
遠吠	トオボエ
遠因	エンイン
遠国	オンゴク
遠山	トオヤマ
遠廻し	トオマワシ
遠征	エンセイ
遠慮	エンリョ
遠方	エンポウ
遠浅	トオアサ
遠眼鏡	トオメガネ
遠藤	エンドウ
遠足	エンソク
遠距離	エンキョリ
遠近	エンキン
遣い	ツカイ
遣り取り	ヤリトリ
遣り口	ヤリクチ
遣唐使	ケントウシ
遣手	ヤリテ
遥	ハルカ
遥か	ハルカ
適	テキ
適例	テキレイ
適切	テキセツ
適宜	テキギ
適度	テキド
適当	テキトウ
遭遇	ソウグウ
遵奉	ジュンポウ
選手	センシュ
選択	センタク
選挙	センキョ
遺伝	イデン
遺憾	イカン
遺憾千万	イカンセンバン
遺族	イゾク
遺書	イショ
遺物	イブツ
遺産	イサン
遺言	ユイゴン
遺誡	イカイ
遺風	イフウ
遺骨	イコツ
避	ヒ
避暑	ヒショ
避暑地	ヒショチ
邂逅	カイコウ
那	ダ
那古	ナゴ
邦	クニ
邪慳	ジャケン
邪推	ジャスイ
邪気	ジャキ
邪淫	ジャイン
邪魔	ジャマ
邯鄲	カンタン
邸	ヤシキ
邸宅	テイタク
郊外	コウガイ
郎	ロウ
部	ブ
部下	ブカ
部分	ブブン
部屋	ヘヤ
部門	ブモン
部類	ブルイ
郵便	ユウビン
郵便局	ユウビンキョク
郵便物	ユウビンブツ
郵便箱	ユウビンバコ
郷里	キョウリ
都	ト
都人士	トジンシ
都会	トカイ
都会人	トカイジン
都合	ツゴウ
都市	トシ
鄭	テイ
鄭重	テイチョウ
酌	シャク
配信	ハイシン
配属	ハイゾク
配布	ハイフ
配当	ハイトウ
配達	ハイタツ
酒	サケ
酒びたり	サケビタリ
酒代	サカダイ
酒場	サカバ
酒屋	サカヤ
酒池肉林	シュチニクリン
酒盛り	サカモリ
酒造り	サケヅクリ
酒量	シュリョウ
酒飲み	サケノミ
酔	ヨイ
酔い	ヨイ
酔っぱらい	ヨッパライ
酔客	スイキャク
酔態	スイタイ
酔漢	スイカン
酔狂	スイキョウ
酢	ス
酢味噌	スミソ
酢豚	スブタ
酷	コク
酷評	コクヒョウ
酸桃	スモモ
醋	ス
醍醐	ダイゴ
醜婦	シュウフ
醜悪	シュウアク
醜態	シュウタイ
醤油	ショウユ
醤油ラーメン	ショウユラーメン
醸造	ジョウゾウ
釈教	シャッキョウ
里	サト
里芋	サトイモ
重	オモ
重々	ジュウジュウ
重き	オモキ
重く	ジュウク
重さ	オモサ
重そう	ジュウソウ
重み	オモミ
重大	ジュウダイ
重太郎	シゲタロウ
重宝	チョウホウ
重役	ジュウヤク
重点	ジュウテン
重病	ジュウビョウ
重箱	ジュウバコ
重要	ジュウヨウ
重量	ジュウリョウ
野	ノ
野中	ノナカ
野分	ノワケ
野卑	ヤヒ
野原	ノハラ
野原中	ノハラナカ
野口	ノグチ
野呂	ノロ
野心	ヤシン
野心家	ヤシンカ
野暮	ヤボ
野猪	ヤチョ
野獣	ヤジュウ
野良	ノラ
野良犬	ノライヌ
野良猫	ノラネコ
野芹	ノゼリ
野茨	ノイバラ
野草	ヤソウ
野菜	ヤサイ
野菜炒め	ヤサイイタメ
野蛮	ヤバン
野蛮人	ヤバンジン
野郎	ヤロウ
野鄙	ヤヒ
量	リョウ
金	キム
金いろ	キンイロ
金も	カネモ
金側	キンガワ
金儲け	カネモウケ
金具	カナグ
金切り声	カナキリゴエ
金剛不壊	コンゴウフエ
金剛石	コンゴウセキ
金力	キンリョク
金善	カネヨシ
金子	カネコ
金巾	カナキン
金平糖	コンペイトウ
金持	カネモチ
金持ち	カネモチ
金日成	キムイルソン
金時	キントキ
金時計	キンドケイ
金柑	キンカン
金槌	カナヅチ
金正日	キムジョンイル
金沢	カナザワ
金満家	キンマンカ
金田	カネダ
金盥	カナダライ
金箔	キンパク
金米糖	コンペイトウ
金網	カナアミ
金縁	キンブチ
金縛り	カナシバリ
金色	キンイロ
金色夜叉	コンジキヤシャ
金銀	キンギン
金銭	キンセン
金鍔	キンツバ
金鎖	キングサリ
金額	キンガク
金魚	キンギョ
金魚鉢	キンギョバチ
釘	クギ
釘付	クギヅケ
釘付け	クギヅケ
釜	カマ
釜中	カマナカ
針	ハリ
針仕事	ハリシゴト
針外し	ハリハズシ
針箱	ハリバコ
針葉樹	シンヨウジュ
針金	ハリガネ
釣	ツリ
釣り	ツリ
釣りに行こう	ツリニイコウ
釣堀	ツリボリ
釣手	ツリテ
釣瓶	ツルベ
釣竿	ツリザオ
釣鐘	ツリガネ
釦	ボタン
鈍	ドン
鈍物	ドンブツ
鈴	スズ
鈴木	スズキ
鈴木将	スズキショウ
鉄	テツ
鉄刀木	テットウボク
鉄心	テッシン
鉄扇	テッセン
鉄拳制裁	テッケンセイサイ
鉄棒	テツボウ
鉄火丼	テッカドン
鉄瓶	テツビン
鉄砲	テッポウ
鉄道	テツドウ
鉄道線路	テツドウセンロ
鉄面皮	テツメンピ
鉛	ナマリ
鉛筆	エンピツ
鉢	ハチ
鉢合	ハチアワセ
鉢合せ	ハチアワセ
鉤	マガリ
鉱山	コウザン
鉾	ホコ
銀	ギン
銀いろ	ギンイロ
銀さん	ギンサン
銀座	ギンザ
銀杏	イチョウ
銀河	ギンガ
銀河鉄道	ギンガテツドウ
銀河鉄道の夜	ギンガテツドウノヨル
銀行	ギンコウ
銀行家	ギンコウカ
銀製	ギンセイ
銀貨	ギンカ
銅	ドウ
銅像	ドウゾウ
銅貨	ドウカ
銅銭	ドウセン
銅鑼	ドラ
銘	メイ
銘木	メイボク
銚子	チョウシ
銭	セン
銭湯	セントウ
銭金	ゼニキン
銷沈	ショウチン
鋒鋩	ホウボウ
鋭敏	エイビン
鋭鋒	エイホウ
鋲	ビョウ
鋳型	イガタ
鋸	ノコ
鋼	ハガネ
鋼玉	コウギョク
錆	サビ
錐	キリ
錘	ツム
錠	ジョウ
錠前	ジョウマエ
錠剤	ジョウザイ
錨	イカリ
錬金術	レンキンジュツ
錯覚	サッカク
録	ロク
鍋	ナベ
鍋中	ナベナカ
鍋焼	ナベヤキ
鍋焼きうどん	ナベヤキウドン
鍔	ツバ
鍔元	ツバモト
鍛冶	タンヤ
鍛冶屋	カジヤ
鍛冶屋町	カジヤマチ
鍬	クワ
鍵	カギ
鎌	カマ
鎌倉	カマクラ
鎌倉の大仏	カマクラノダイブツ
鎌倉幕府	カマクラバクフ
鎌倉時代	カマクラジダイ
鎌首	カマクビ
鎖	クサリ
鎧	ヨロイ
鎮座	チンザ
鏡	カガミ
鏡花	キョウカ
鐘	カネ
鑑定	カンテイ
鑑賞	カンショウ
長	ナガ
長い	ナガイ
長い散歩	ナガイサンポ
長い草	ナガイクサ
長い間	ナガイアイダ
長え	ナガエ
長き	チョウキ
長さ	ナガサ
長久	チョウキュウ
長兄	チョウケイ
長吉	チョウキチ
長坂	ナガサカ
長夜	チョウヤ
長大	チョウダイ
長女	チョウジョ
長寿	チョウジュ
長居	ナガイ
長屋	ナガヤ
長崎	ナガサキ
長州征伐	チョウシュウセイバツ
長持ち	ナガモチ
長時間	チョウジカン
長瀬川	ナガセガワ
長火鉢	ナガヒバチ
長生	チョウセイ
長生き	ナガイキ
長男	チョウナン
長範	ナガノリ
長篇	チョウヘン
長者	チョウジャ
長谷	ナガタニ
長閑	ノドカ
長靴	ナガグツ
門	モン
門下	モンカ
門下生	モンカセイ
門前	モンゼン
門口	カドグチ
門外漢	モンガイカン
門松	カドマツ
閉口	ヘイコウ
閉塞	ヘイソク
閉居	ヘイキョ
閉鎖	ヘイサ
開か	カイカ
開かん	カイカン
開き	ヒラキ
開き戸	ヒラキド
開会	カイカイ
開催	カイサイ
開化	カイカ
開墾	カイコン
開拓	カイタク
開放	カイホウ
開明	カイメイ
開校	カイコウ
開業	カイギョウ
開花	カイカ
開陳	カイチン
閑	カン
閑人	ヒマジン
閑却	カンキャク
閑暇	カンカ
閑静	カンセイ
間	マ
間そう	カンソウ
間に合せ	マニアワセ
間一髪	カンイッパツ
間不容髪	カンフヨウハツ
間中	マナカ
間取	マトリ
間口	マグチ
間抜	マヌケ
間抜け	マヌケ
間接	カンセツ
間接射撃	カンセツシャゲキ
間断	カンダン
間板	マイタ
間柄	アイダガラ
間然	カンゼン
間男	マオトコ
間近	マヂカ
間違い	マチガイ
間隔	カンカク
間際	マギワ
間食	カンショク
間鼻	マハナ
関	セキ
関の戸	セキノト
関係	カンケイ
関心	カンシン
関白	カンパク
関知	カンチ
関節	カンセツ
関西	カンサイ
関連	カンレン
閣下	カッカ
閲覧	エツラン
閻魔	エンマ
闇	ヤミ
闇夜	ヤミヨ
闊達	カッタツ
闖入	チンニュウ
防	ボウ
防ぐ	ボウグ
防禦	ボウギョ
阿倍	アベ
阿倍御主人	アベノミウシ
阿呆	アホ
阿弥	アミ
阿部	アベ
阿鼻叫喚	アビキョウカン
阿鼻地獄	アビジゴク
附	フ
附き	フキ
附加	フカ
附属	フゾク
附記	フキ
附近	フキン
附録	フロク
陋劣	ロウレツ
陋習	ロウシュウ
降参	コウサン
降雪	コウセツ
限	キリ
限り	カギリ
陛下	ヘイカ
院	イン
院外	インガイ
院長	インチョウ
陣	ジン
陣地	ジンチ
陣立て	ジンダテ
陣笠	ジンガサ
陣羽織	ジンバオリ
除去	ジョキョ
除名	ジョメイ
陥落	カンラク
陰	カゲ
陰口	カゲグチ
陰惨	インサン
陰気	インキ
陰鬱	インウツ
陳	チン
陳列	チンレツ
陳腐	チンプ
陳述	チンジュツ
陵	リョウ
陶器	トウキ
陶然	トウゼン
陸	リク
陸海軍	リクカイグン
陸軍	リクグン
険	ケン
険悪	ケンアク
陽性	ヨウセイ
陽春	ヨウシュン
陽気	ヨウキ
陽炎	カゲロウ
隅	スミ
隅々	スミズミ
隅っこ	スミッコ
隅田川	スミダガワ
隆生	タカオ
隆盛	リュウセイ
隆起	リュウキ
隊	タイ
隊伍	タイゴ
隊長	タイチョウ
階	カイ
階下	カイカ
階段	カイダン
随い	ズイイ
随処	ズイショ
随処任意	ズイショニンイ
随分	ズイブン
随意	ズイイ
随行	ズイコウ
隔たり	ヘダタリ
隔て	ヘダテ
隔離	カクリ
隙	ヒマ
隙間	スキマ
際	サイ
際こと	キワコト
際会	サイカイ
際限	サイゲン
障り	サワリ
障子	ショウジ
障害	ショウガイ
隠し	カクシ
隠し場所	カクシバショ
隠し立て	カクシダテ
隠し芸	カクシゲイ
隠れ	カクレ
隠れ家	カクレガ
隠居	インキョ
隠岐	オキ
隠蔽	インペイ
隠語	インゴ
隣	トナリ
隣人	リンジン
隣国	リンゴク
隣室	リンシツ
隣家	リンカ
隧道	ズイドウ
隷属	レイゾク
雁	カリ
雄	ユウ
雄弁	ユウベン
雅	ミヤビ
雅言	ガゲン
集	シュウ
集り	アツマリ
集中	シュウチュウ
集合	シュウゴウ
集合体	シュウゴウタイ
集英社	シュウエイシャ
集英社文庫	シュウエイシャブンコ
集計	シュウケイ
雇主	ヤトイヌシ
雉	キジ
雌	メス
雌雄	シユウ
雑	ザツ
雑作	ゾウサ
雑兵	ゾウヒョウ
雑司ヶ谷	ゾウシガヤ
雑多	ザッタ
雑居	ザッキョ
雑巾	ゾウキン
雑沓	ザットウ
雑炊	ゾウスイ
雑煮	ゾウニ
雑物	ゾウモツ
雑誌	ザッシ
雑誌社	ザッシシャ
雑談	ザツダン
雑貨店	ザッカテン
雑費	ザッピ
雑魚	ジャコ
雛	ヒナ
離	ハナレ
離れ	ハナレ
離れ離れ	ハナレバナレ
離合開闔	リゴウカイコウ
離縁	リエン
難	ナン
難事	ナンジ
難儀	ナンギ
難所	ナンショ
難易	ナンイ
難渋	ナンジュウ
難物	ナンブツ
難症	ナンショウ
難癖	ナンクセ
難船	ナンセン
難行苦行	ナンギョウクギョウ
難解	ナンカイ
難解な	ナンカイナ
難関	ナンカン
難題	ナンダイ
雨	アメ
雨の音	アメノオト
雨上り	アメアガリ
雨垂れ	アマダレ
雨宿り	アマヤドリ
雨戸	アマド
雨風	アメカゼ
雪	ユキ
雪女	ユキオンナ
雪女郎	ユキジョロウ
雪江	ユキエ
雪煙	ユキケムリ
雪見だいふく	ユキミダイフク
雪踏	セッタ
雪隠	セッチン
雫	シズク
雰囲気	フンイキ
雲	クモ
雲に乗って	クモニノッテ
雲の影	クモノカゲ
雲井	クモイ
雲助	クモスケ
雲母	ウンモ
雲水行脚	ウンスイアンギャ
雲泥の差	ウンデイノサ
雲照	ウンショウ
雲霞	ウンカ
零	レイ
零落	レイラク
雷	カミナリ
電	デン
電しんばしら	デンシンバシラ
電信	デンシン
電信ばしら	デンシンバシラ
電光	デンコウ
電光影裏	デンコウエイリ
電力	デンリョク
電動	デンドウ
電卓	デンタク
電報	デンポウ
電柱	デンチュウ
電気	デンキ
電気ブラン	デンキブラン
電気鉄道	デンキテツドウ
電燈	デントウ
電線	デンセン
電話	デンワ
電話帳	デンワチョウ
電話機	デンワキ
電話番号	デンワバンゴウ
電車	デンシャ
電車通り	デンシャドオリ
電鉄	デンテツ
震え	フルエ
震動	シンドウ
震撼	シンカン
霊	レイ
霊か	レイカ
霊妙	レイミョウ
霊気	レイキ
霊猫	ジャコウネコ
霊異	レイイ
霊験	レイケン
霊魂	レイコン
霜	シモ
霜柱	シモバシラ
霜解	シモドケ
霞	カスミ
霧	キリ
霧島	キリシマ
露	ロ
露出	ロシュツ
露地	ロジ
露西亜	ロシア
露見	ロケン
露骨	ロコツ
霹靂	ヘキレキ
青	アオ
青のり	アオノリ
青坊主	アオボウズ
青大将	アオダイショウ
青嶋	アオシマ
青年	セイネン
青春	セイシュン
青桐	アオギリ
青梗菜	チンゲンサイ
青森県	アオモリケン
青椒肉絲	チンジャオロース
青磁	セイジ
青空	アオゾラ
青空文庫	アオゾラブンコ
青竜	セイリュウ
青葉	アオバ
青軸	アオジク
静	セイ
静か	シズカ
静坐	セイザ
静岡	シズオカ
静粛	セイシュク
静謐	セイヒツ
静養	セイヨウ
非	ヒ
非公式	ヒコウシキ
非凡	ヒボン
非合法	ヒゴウホウ
非常	ヒジョウ
非常識	ヒジョウシキ
非礼	ヒレイ
非表示	ヒヒョウジ
非道	ヒドウ
非難	ヒナン
面	メン
面会	メンカイ
面倒	メンドウ
面前	メンゼン
面影	オモカゲ
面晤	メンゴ
面構	ツラガマエ
面構え	ツラガマエ
面白	オモシロ
面白い本	オモシロイホン
面白半分	オモシロハンブン
面皰	ニキビ
面目	メンボク
面目次第	メンボクシダイ
面積	メンセキ
面詰	メンキツ
面長	オモナガ
革	カワ
革命	カクメイ
靴	クツ
鞄	カバン
鞍懸	クラカケ
鞍馬寺	クラマデラ
鞍馬山	クラマヤマ
鞘	サヤ
鞭	ムチ
鞭撻	ベンタツ
韋駄天	イダテン
韓	カン
韓国	カンコク
韮	ニラ
音	オト
音いろ	ネイロ
音信	オンシン
音声	オンセイ
音曲	オンギョク
音楽	オンガク
音楽会	オンガクカイ
音楽学校	オンガクガッコウ
音色	ネイロ
音量	オンリョウ
音響	オンキョウ
韻	イン
響	ヒビキ
響き	ヒビキ
頁	ページ
頂	イタダキ
頂上	チョウジョウ
頂戴	チョウダイ
頂点	チョウテン
頃	コロ
項目	コウモク
順	ジュン
順々	ジュンジュン
順列	ジュンレツ
順序	ジュンジョ
順当	ジュントウ
順番	ジュンバン
順良	ジュンリョウ
順路	ジュンロ
頑固	ガンコ
頑愚	ガング
頓	トミ
頓挫	トンザ
頓服	トンプク
頓死	トンシ
頓狂	トンキョウ
頓珍漢	トンチンカン
頓着	トンジャク
領	リョウ
領主	リョウシュ
領分	リョウブン
頬	ホオ
頬杖	ホオヅエ
頬骨	ホオボネ
頭	アタマ
頭中将	トウノチュウジョウ
頭寒足熱	ズカンソクネツ
頭巾	ズキン
頭数	トウスウ
頭文字	カシラモジ
頭痛	ズツウ
頭脳	ズノウ
頭蓋骨	ズガイコツ
頭領	トウリョウ
頭髪	トウハツ
頻繁	ヒンパン
頼	ヨリユキ
頼み	タノミ
頼り	タヨリ
頼朝	ヨリトモ
題	ダイ
題名	ダイメイ
題目	ダイモク
額	ガク
顎	アゴ
顔	カオ
顔いろ	カオイロ
顔かたち	カオカタチ
顔つき	カオツキ
顔付	カオツキ
顔色	カオイロ
顔面	ガンメン
顔面神経	ガンメンシンケイ
顕著	ケンチョ
願	ネガイ
願い	ネガイ
願い事	ネガイゴト
願望	ガンボウ
顛倒	テントウ
顛末	テンマツ
類	ルイ
類似	ルイジ
類例	ルイレイ
類型	ルイケイ
類聚	ルイジュウ
顧	グ
顧慮	コリョ
風	カゼ
風か	フウカ
風がわり	フウガワリ
風になって	カゼニナッテ
風に吹かれて	カゼニフカレテ
風のように	カゼノヨウニ
風の人	カゼノヒト
風の言葉	カゼノコトバ
風の音	カゼノオト
風上	カザカミ
風体	フウテイ
風俗	フウゾク
風儀	フウギ
風南	カナン
風合い	フウアイ
風呂	フロ
風呂敷	フロシキ
風味	フウミ
風変り	フウガワリ
風情	フゼイ
風教	フウキョウ
風景	フウケイ
風来坊	フウライボウ
風波	フウハ
風流	フリュウ
風紀	フウキ
風習	フウシュウ
風船	フウセン
風船玉	フウセンダマ
風通し	カゼトオシ
風邪	カゼ
風采	フウサイ
飄然	ヒョウゼン
飛	ヒ
飛び込み	トビコミ
飛白	ヒハク
飛花落葉	ヒカラクヨウ
飛衣	トイ
飛車	ヒシャ
飛道具	トビドウグ
飛鳥	アスカ
食	ショク
食い	クイ
食い倒れ	クイダオレ
食い意地	クイイジ
食い気	クイケ
食い物	クイモノ
食べに	ショクベニ
食べ残し	タベノコシ
食べ物	タベモノ
食事	ショクジ
食前	ショクゼン
食卓	ショクタク
食堂	ショクドウ
食客	ショッキャク
食後	ショクゴ
食意地	クイイジ
食指	ショクシ
食料	ショクリョウ
食欲	ショクヨク
食物	ショクモツ
食用	ショクヨウ
食部	ショクブ
飯	メシ
飯櫃	メシビツ
飯粒	メシツブ
飲み物	ノミモノ
飲酒	インシュ
飲食店	インショクテン
飴	アメ
飾り	カザリ
飾りつけ	カザリツケ
餃子	ギョウザ
餅	モチ
餅屋	モチヤ
餅菓子	モチガシ
養	ヨウ
養子	ヨウシ
養家	ヨウカ
養成	ヨウセイ
養源寺	ヨウゲンジ
養父	ヨウフ
養父母	ヨウフボ
養生	ヨウジョウ
餌	エサ
餌食	エジキ
餓死	ガシ
餓鬼大将	ガキダイショウ
餞別	センベツ
館	タテ
饂飩	ウドン
饑饉	キキン
饒舌	ジョウゼツ
饗宴	キョウエン
首	クビ
首っ引き	クビッピキ
首に	クビニ
首実検	クビジッケン
首尾	シュビ
首尾相応	シュビソウオウ
首筋	クビスジ
首縊り	クビククリ
首肯	シュコウ
首脳	シュノウ
首輪	クビワ
香	コウ
香の物	コウノモノ
香一	コウイチ
香具師	コウグシ
香味野菜	コウミヤサイ
香木	コウボク
香水	コウスイ
香炉	コウロ
香車	キョウシャ
馬	ウマ
馬の骨	ウマノホネ
馬丁	バテイ
馬堤	ウマヅツミ
馬子	マゴ
馬琴	バキン
馬耳東風	バジトウフウ
馬肉	バニク
馬車	バシャ
馬車馬	バシャウマ
馬鈴	ムマノスズ
馬鈴薯	ジャガイモ
馬鹿	バカ
馬鹿者	バカモノ
馬鹿野郎	バカヤロウ
馳	ハセ
馴染	ナジミ
馴染み	ナジミ
駄々	ダダ
駄弁	ダベン
駄洒落	ダジャレ
駄目	ダメ
駄菓子屋	ダガシヤ
駄馬	ダバ
駅	エキ
駅売り	エキウリ
駅長	エキチョウ
駆逐	クチク
駒	コマ
駒下駄	コマゲタ
駒込	コマゴメ
駱駝	ラクダ
駿河	スルガ
駿河国	スルガノクニ
騎	キ
騒ぎ	サワギ
騒動	ソウドウ
験	ケン
驚	オドロキ
驚き	オドロキ
驚嘆	キョウタン
驚愕	キョウガク
驢馬	ロバ
骨	ホネ
骨折り損	ホネオリゾン
骨抜	ホネヌキ
骨抜き	ホネヌキ
骨格	コッカク
骨組み	ホネグミ
骨肉	コツニク
骨董	コットウ
骨身	ホネミ
骨頂	コッチョウ
骸	ムクロ
高	コウ
高い	タカイ
高い窓	タカイマド
高き	コウキ
高さ	タカサ
高低	コウテイ
高価	コウカ
高僧	コウソウ
高円寺	コウエンジ
高円寺駅	コウエンジエキ
高利貸	コウリカシ
高原	コウゲン
高名	コウミョウ
高尚	コウショウ
高山彦九郎	タカヤマヒコクロウ
高島田	タカシマダ
高度	コウド
高慢	コウマン
高慢ちき	コウマンチキ
高橋	タカハシ
高浜虚子	タカハマキョシ
高潔	コウキヨシ
高潮	コウチョウ
高知	コウチ
高等	コウトウ
高等学校	コウトウガッコウ
高級	コウキュウ
高話	コウワ
高踏	コウトウ
高輪	タカナワ
高野	タカノ
高齢	コウレイ
髣髴	ホウフツ
髪	カミ
髪の毛	カミノケ
髪結床	カミユイドコ
髭	ヒゲ
髯	ヒゲ
髷	マゲ
鬘	カツラ
鬚	ヒゲ
鬢	ビン
鬨の声	トキノコエ
鬼	オニ
鬼が島	オニガシマ
鬼ケ島	オニガシマ
鬼気	キキ
鬼瓦	オニガワラ
鬼神のお松	キジンノオマツ
魂	タマシイ
魂胆	コンタン
魑魅	スダマ
魔	マ
魔力	マリョク
魔法	マホウ
魔物	マモノ
魚	サカナ
魚の	ウオノ
魚介類	ギョカイルイ
魚醤	ギョショウ
魚類	ギョルイ
鮑	アワビ
鮒	フナ
鮨	スシ
鮪	マグロ
鮭	サケ
鮮やか	アザヤカ
鮮明	センメイ
鯉	コイ
鯛	タイ
鯛の浦	タイノウラ
鯨	クジラ
鯱	シャチ
鰌	ドジョウ
鰐	ワニ
鰡	ボラ
鰹	カツオ
鰹節	カツオブシ
鰻	ウナギ
鰻谷	ウナギダニ
鱒	マス
鳥	トリ
鳥の子紙	トリノコガミ
鳥取	トットリ
鳥取県湯梨浜町	トットリケンユリハマチョウ
鳥屋	トリヤ
鳥部	トリベ
鳥類	チョウルイ
鳩	ハト
鳳	オオトリ
鳳仙	ホウセンカ
鳴き声	ナキゴエ
鳴り	ナリ
鳶口	トビグチ
鳶色	トビイロ
鴉	カラス
鴎	カモメ
鴛鴦	エンオウ
鴟尾	シビ
鴨	カモ
鴨南蛮	カモナンバン
鴻	オオトリ
鵜	ウ
鵜呑	ウノミ
鵞毛	ガモウ
鵯越	ヒヨドリゴエ
鶉	ウズラ
鶏	ニワトリ
鶏ガラスープの素	トリガラスープノモト
鶏卵	ケイラン
鶏肉	ケイニク
鶯	ウグイス
鶴	ツル
鶴嘴	ツルハシ
鶴館	ツルダテ
鷲	ワシ
鷹	タカ
鷹匠町	タカジョウマチ
鷹揚	オウヨウ
鷺	サギ
鹿	シカ
鹿児島	カゴシマ
鹿爪	シカヅメ
麈	オオジカ
麓	フモト
麗	ウララ
麗質	レイシツ
麦藁	ムギワラ
麦藁帽子	ムギワラボウシ
麦酒	ビール
麦飯	ムギメシ
麩	フスマ
麹町	コウジマチ
麺	メン
麺棒	メンボウ
麺類	メンルイ
麻	アサ
麻呂	マロ
麻婆丼	マーボードン
麻婆茄子	マーボーナス
麻婆豆腐	マアボウドウフ
麻布	マフ
麻痺	マヒ
麻裏	アサウラ
麻雀	マージャン
黄	キ
黄いろ	キイロ
黄玉	オウギョク
黄瓜	キュウリ
黄白青銭	コウハクセイセン
黄色	キイロ
黄色い顔	キイロイカオ
黄葉	コウヨウ
黄金	オウゴン
黄金律	オウゴンリツ
黄鶴	コウカク
黍	キビ
黍団子	キビダンゴ
黒	クロ
黒こしょう	クロコショウ
黒人	コクジン
黒布	クロメ
黒曜石	コクヨウセキ
黒服	クロフク
黒板	コクバン
黒板消し	コクバンケシ
黒柿	クロガキ
黒棒	クロボウ
黒檀	コクタン
黒洞	クロボラ
黒点	コクテン
黒焦	クロコゲ
黒猫	クロネコ
黒甜郷裡	コクテンキョウリ
黒白	クロシロ
黒石	クロイシ
黒装束	クロショウゾク
黒谷	クロタニ
黒酢	クロズ
黒雲	クロクモ
黒髪	クロカミ
黙殺	モクサツ
黙然	モクゼン
黙読	モクドク
黙過	モッカ
黴	カビ
黴菌	バイキン
鼈	スッポン
鼎坐	テイザ
鼓動	コドウ
鼓吹	コスイ
鼓膜	コマク
鼓舞	コブ
鼠	ネズミ
鼠いろ	ネズミイロ
鼠色	ネズミイロ
鼠賊	ソゾク
鼻	ハナ
鼻孔	ビコウ
鼻息	ハナイキ
鼻柱	ハナバシラ
鼻梁	ビリョウ
鼻毛	ハナゲ
鼻毛を抜く	ハナゲヲヌク
鼻汁	ハナシル
鼻筋	ハナスジ
鼻紙	ハナガミ
鼻緒	ハナオ
鼾	イビキ
齷齪	アクセク
龍	リュウ
％	パーセント
１	イチ
１月	イチガツ
２	ニ
３	サン
５	ゴ
６	ロク
７	ナナ
８	ハチ
Ｋ	ケイ
Ｋさん	ケイサン
Ｐ	ピー
🌱	フタバ
🌾	イナホ
🌿	ハーブ
🍆	ナス
🔹	ヒシガタ
🥕	ニンジン
