国の一覧	クニノイチラン
著作権の保護期間	チョサクケンノホゴキカン
台東区	タイトウク
こどもの文化	コドモノブンカ
特撮	トクサツ
日常生活	ニチジョウセイカツ
情報工学	ジョウホウコウガク
形式言語	ケイシキゲンゴ
文脈自由言語	ブンミャクジユウゲンゴ
自然言語	シゼンゲンゴ
宗教学	シュウキョウガク
新聞学	シンブンガク
両国国技館	リョウゴクコクギカン
薬学	ヤクガク
身体装飾	シンタイソウショク
宝石	ホウセキ
液晶	エキショウ
言語学	ゲンゴガク
映画	エイガ
画像	ガゾウ
記録	キロク
合理主義哲学	ゴウリシュギテツガク
日本の漫画作品一覧	ニホンノマンガサクヒンイチラン
民族音楽	ミンゾクオンガク
岩手県	イワテケン
個人	コジン
将軍	ショウグン
食文化	ショクブンカ
風邪	カゼ
内閣総理大臣の一覧	ナイカクソウリダイジンノイチラン
石川県	イシカワケン
愛媛県	エヒメケン
大分県	オオイタケン
岡山県	オカヤマケン
香川県	カガワケン
岐阜県	ギフケン
熊本県	クマモトケン
高知県	コウチケン
佐賀県	サガケン
滋賀県	シガケン
静岡県	シズオカケン
島根県	シマネケン
徳島県	トクシマケン
栃木県	トチギケン
鳥取県	トットリケン
長崎県	ナガサキケン
長野県	ナガノケン
新潟県	ニイガタケン
兵庫県	ヒョウゴケン
広島県	ヒロシマケン
福井県	フクイケン
福島県	フクシマケン
北海道	ホッカイドウ
宮崎県	ミヤザキケン
山口県	ヤマグチケン
山梨県	ヤマナシケン
和歌山県	ワカヤマケン
介錯	カイシャク
少年漫画	ショウネンマンガ
少女漫画	ショウジョマンガ
経営学	ケイエイガク
日本の伝統芸能	ニホンノデントウゲイノウ
一節切	ヒトヨギリ
日付の一覧	ヒヅケノイチラン
株式	カブシキ
経営参加権	ケイエイサンカケン
利益配当請求権	リエキハイトウセイキュウケン
残余財産分配請求権	ザンヨザイサンブンパイセイキュウケン
値幅制限	ネハバセイゲン
呼び値	ヨビネ
配当	ハイトウ
株券	カブケン
株価指数	カブカシスウ
青年漫画	セイネンマンガ
篳篥	ヒチリキ
三線	サンシン
銀玉鉄砲	ギンダマデッポウ
笑い袋	ワライブクロ
築山	ツキヤマ
庭師	ニワシ
野球盤	ヤキュウバン
太陽暦	タイヨウレキ
兼六園	ケンロクエン
貸本漫画	カシホンマンガ
医療漫画	イリョウマンガ
劇画	ゲキガ
旭川市	アサヒカワシ
統計図表	トウケイズヒョウ
認識論	ニンシキロン
震度	シンド
内戦	ナイセン
暗号	アンゴウ
統計学	トウケイガク
弘前市	ヒロサキシ
地震	ジシン
東北地方	トウホクチホウ
日本文学	ニホンブンガク
生成文法	セイセイブンポウ
映画監督一覧	エイガカントクイチラン
経済学	ケイザイガク
機械工学	キカイコウガク
建築学	ケンチクガク
考古学	コウコガク
熱力学	ネツリキガク
海外	カイガイ
超伝導	チョウデンドウ
地衣類	チイルイ
計算物理学	ケイサンブツリガク
博物学	ハクブツガク
百科事典	ヒャッカジテン
物性物理学	ブッセイブツリガク
磁性体	ジセイタイ
誘電体	ユウデンタイ
奈良線	ナラセン
分子生物学	ブンシセイブツガク
脳科学	ノウカガク
調理法	チョウリホウ
横須賀市	ヨコスカシ
日食	ニッショク
彗星	スイセイ
衛星	エイセイ
龍安寺	リョウアンジ
老子	ロウシ
戦争	センソウ
玉音放送	ギョクオンホウソウ
佐鳴湖	サナルコ
自動車競技	ジドウシャキョウギ
人類学	ジンルイガク
古典落語	コテンラクゴ
東ケト会	トウケトカイ
本の雑誌社	ホンノザッシシャ
将棋	ショウギ
民俗学	ミンゾクガク
上方落語	カミガタラクゴ
舞台	ブタイ
6月	ロクガツ
8月	ハチガツ
9月	クガツ
11月	ジュウイチガツ
12月	ジュウニガツ
大陸	タイリク
園芸学	エンゲイガク
大正	タイショウ
四書五経	シショゴキョウ
雑誌	ザッシ
7並べ	シチナラベ
気象予報士	キショウヨホウシ
音声多重放送	オンセイタジュウホウソウ
場の量子論	バノリョウシロン
百人一首	ヒャクニンイッシュ
波動関数	ハドウカンスウ
並列化	ヘイレツカ
単位胞	タンイホウ
俳優	ハイユウ
儒教	ジュキョウ
帝国大学	テイコクダイガク
産業財産権法	サンギョウザイサンケンホウ
作家	サッカ
一般化勾配近似	イッパンカコウバイキンジ
詩人一覧	シジンイチラン
非線形物理学	ヒセンケイブツリガク
人名一覧	ジンメイイチラン
狩野派	カノウハ
波数	ハスウ
補助記憶装置	ホジョキオクソウチ
監督	カントク
正準量子化	セイジュンリョウシカ
栽培品種	サイバイヒンシュ
太陽風	タイヨウフウ
構文解析	コウブンカイセキ
太陰太陽暦	タイインタイヨウレキ
天気図	テンキズ
語義の曖昧性解消	ゴギノアイマイセイカイショウ
電荷密度	デンカミツド
構文解析器	コウブンカイセキキ
川	カワ
構文木	コウブンギ
北海道大学	ホッカイドウダイガク
欧州共同体	オウシュウキョウドウタイ
固定焦点	コテイショウテン
陸	リク
魏志倭人伝	ギシワジンデン
赤窓	アカマド
歌手	カシュ
料理	リョウリ
検索	ケンサク
混合基底	コンゴウキテイ
計算複雑性理論	ケイサンフクザツセイリロン
本	ホン
山弦	ヤマゲン
新書	シンショ
図書館	トショカン
湖沼	コショウ
線型結合	センケイケツゴウ
田沢湖	タザワコ
湾	ワン
3世紀	サンセイキ
形態素	ケイタイソ
未知語	ミチゴ
問い合わせ言語	トイアワセゲンゴ
線形探索	センケイタンサク
軍人将棋	グンジンショウギ
笑い	ワライ
学習	ガクシュウ
印刷	インサツ
自動車	ジドウシャ
編曲家	ヘンキョクカ
風物詩	フウブツシ
編曲	ヘンキョク
統一地方選挙	トウイツチホウセンキョ
江戸時代	エドジダイ
一世一元の詔	イッセイイチゲンノミコトノリ
枕	マクラ
引き伸ばし機	ヒキノバシキ
周期表	シュウキヒョウ
漢字	カンジ
趣味	シュミ
倒産	トウサン
平仮名	ヒラガナ
22世紀	ニジュウニセイキ
食材	ショクザイ
野菜	ヤサイ
集積回路	シュウセキカイロ
製本	セイホン
可逆圧縮	カギャクアッシュク
非可逆圧縮	ヒカギャクアッシュク
内燃機関	ナイネンキカン
正規表現	セイキヒョウゲン
直交化	チョッコウカ
録音再生機器	ロクオンサイセイキキ
駿河湾	スルガワン
乱数列	ランスウレツ
国語国字問題	コクゴコクジモンダイ
品種	ヒンシュ
日本語字幕	ニホンゴジマク
流通	リュウツウ
欧州連合加盟国	オウシュウレンゴウカメイコク
線形合同法	センケイゴウドウホウ
胎座	タイザ
一年生植物	イチネンセイショクブツ
農業	ノウギョウ
魚類	ギョルイ
齧歯目	ゲッシモク
電気泳動	デンキエイドウ
軍艦じゃんけん	グンカンジャンケン
大阪環状線	オオサカカンジョウセン
青春映画	セイシュンエイガ
戦争映画	センソウエイガ
時代劇	ジダイゲキ
西部劇	セイブゲキ
恋愛映画	レンアイエイガ
枝豆	エダマメ
白浜町	シラハマチョウ
穀物	コクモツ
御殿場線	ゴテンバセン
低水準言語	テイスイジュンゲンゴ
販売	ハンバイ
機械翻訳	キカイホンヤク
柑橘類	カンキツルイ
珠心胚実生	シュシンハイミショウ
串本町	クシモトチョウ
太地町	タイジチョウ
奈良時代	ナラジダイ
小説家	ショウセツカ
星座占い	セイザウラナイ
生産者	セイサンシャ
生産	セイサン
業種	ギョウシュ
耳	ミミ
未確認物体	ミカクニンブッタイ
日本の行政機関	ニホンノギョウセイキカン
習志野市	ナラシノシ
読書	ドクショ
漁業	ギョギョウ
計算機	ケイサンキ
基底状態	キテイジョウタイ
励起状態	レイキジョウタイ
超短波	チョウタンパ
西高東低	セイコウトウテイ
風	カゼ
節句	セック
行政	ギョウセイ
極超短波	ゴクチョウタンパ
周期的境界条件	シュウキテキキョウカイジョウケン
五感	ゴカン
三越	ミツコシ
外務省	ガイムショウ
農林水産省	ノウリンスイサンショウ
酪農	ラクノウ
未確認飛行物体	ミカクニンヒコウブッタイ
京都市営地下鉄	キョウトシエイチカテツ
符号化方式	フゴウカホウシキ
旧約聖書	キュウヤクセイショ
社会保険庁	シャカイホケンチョウ
物理学者の一覧	ブツリガクシャノイチラン
流体力学	リュウタイリキガク
連続体力学	レンゾクタイリキガク
関東地方	カントウチホウ
映像機器	エイゾウキキ
津田沼	ツダヌマ
京成津田沼駅	ケイセイツダヌマエキ
津田沼駅	ツダヌマエキ
総武本線	ソウブホンセン
青砥駅	アオトエキ
東成田駅	ヒガシナリタエキ
推理小説	スイリショウセツ
漫画家一覧	マンガカイチラン
日本の漫画家一覧	ニホンノマンガカイチラン
紙切り	カミキリ
知恵の輪	チエノワ
推理作家一覧	スイリサッカイチラン
登山	トザン
細胞分裂	サイボウブンレツ
金属	キンゾク
絶縁体	ゼツエンタイ
千葉駅	チバエキ
総武線	ソウブセン
受粉	ジュフン
京都駅	キョウトエキ
陸軍記念日	リクグンキネンビ
文庫	ブンコ
共有結合結晶	キョウユウケツゴウケッショウ
語学	ゴガク
天皇の一覧	テンノウノイチラン
交通	コウツウ
首都の一覧	シュトノイチラン
中近東	チュウキントウ
銀行	ギンコウ
市中銀行	シチュウギンコウ
中央銀行	チュウオウギンコウ
都市銀行	トシギンコウ
競馬の競走一覧	ケイバノキョウソウイチラン
新たな形態の銀行	アラタナケイタイノギンコウ
直通運転	チョクツウウンテン
鉄道事業者	テツドウジギョウシャ
空港	クウコウ
天の川	アマノガワ
日本の高速道路	ニッポンノコウソクドウロ
天王星	テンノウセイ
阪和線	ハンワセン
軌間	キカン
時空	ジクウ
面積	メンセキ
神	カミ
東京都交通局	トウキョウトコウツウキョク
日本の鉄道駅	ニホンノテツドウエキ
日本の鉄道駅一覧	ニッポンノテツドウエキイチラン
記憶	キオク
生命	セイメイ
琵琶湖線	ビワコセン
有理数	ユウリスウ
高井戸	タカイド
認証	ニンショウ
電気工学	デンキコウガク
鉄道路線	テツドウロセン
日本の鉄道路線一覧	ニッポンノテツドウロセンイチラン
日本の鉄軌道事業者一覧	ニホンノテツキドウジギョウシャイチラン
水族館	スイゾクカン
船橋競馬場駅	フナバシケイバジョウエキ
谷津駅	ヤツエキ
旅客	リョカク
乗車券	ジョウシャケン
天王寺駅	テンノウジエキ
通貨	ツウカ
野田阪神駅	ノダハンシンエキ
廃語	ハイゴ
出版社	シュッパンシャ
歴史上の人物一覧	レキシジョウノジンブツイチラン
南紀白浜空港	ナンキシラハマクウコウ
芸術家	ゲイジュツカ
画家	ガカ
運賃	ウンチン
親指	オヤユビ
合衆国	ガッシュウコク
合金	ゴウキン
金属間化合物	キンゾクカンカゴウブツ
9世紀	キュウセイキ
相転移	ソウテンイ
東京湾	トウキョウワン
16世紀	ジュウロクセイキ
京王新線	ケイオウシンセン
日本電信電話公社	ニッポンデンシンデンワコウシャ
立川駅	タチカワエキ
中部地方	チュウブチホウ
出版	シュッパン
自費出版	ジヒシュッパン
九州大学	キュウシュウダイガク
中央省庁再編	チュウオウショウチョウサイヘン
平方根	ヘイホウコン
単位一覧	タンイイチラン
中国地方	チュウゴクチホウ
賞の一覧	ショウノイチラン
衆議院	シュウギイン
仏教遺跡	ブッキョウイセキ
国会議員	コッカイギイン
大統領	ダイトウリョウ
金属結合	キンゾクケツゴウ
紀元前25世紀	キゲンゼンニジュウゴセイキ
紀元前3千年紀	キゲンゼンサンゼンネンキ
高松宮記念	タカマツノミヤキネン
両生類	リョウセイルイ
明治維新	メイジイシン
上野駅	ウエノエキ
無線通信	ムセンツウシン
西日暮里駅	ニシニッポリエキ
電話機	デンワキ
新保守主義	シンホシュシュギ
硬水	コウスイ
軟水	ナンスイ
酒	サケ
規制緩和	キセイカンワ
抵抗器	テイコウキ
中共	チュウキョウ
箱根湯本駅	ハコネユモトエキ
町屋駅	マチヤエキ
浄土真宗	ジョウドシンシュウ
自然数	シゼンスウ
聖戦	セイセン
基底関数	キテイカンスウ
4世紀	ヨンセイキ
大学一覧	ダイガクイチラン
大学院	ダイガクイン
格子振動	コウシシンドウ
死刑	シケイ
私刑	シケイ
死刑存廃問題	シケイソンパイモンダイ
紀元前4世紀	キゲンゼンヨンセイキ
関心空間	カンシンクウカン
2世紀	ニセイキ
植物	ショクブツ
国際連合安全保障理事会	コクサイレンゴウアンゼンホショウリジカイ
富士山	フジサン
天理市	テンリシ
関東	カントウ
大和国	ヤマトノクニ
大和	ヤマト
臨済宗妙心寺派	リンザイシュウミョウシンジハ
臨済宗円覚寺派	リンザイシュウエンカクジジハ
名古屋大学	ナゴヤダイガク
大学入学資格検定	ダイガクニュウガクシカクケンテイ
車輪	シャリン
李氏朝鮮	リシチョウセン
電車	デンシャ
普化宗	フケシュウ
円覚寺	エンガクジ
臨済宗建仁寺派	リンザイシュウケンニンジハ
臨済宗東福寺派	リンザイシュウトウフクジハ
臨済宗建長寺派	リンザイシュウケンチョウジジハ
臨済宗南禅寺派	リンザイシュウナンゼンジハ
臨済宗大徳寺派	リンザイシュウダイトクジハ
電動機	デンドウキ
大阪大空襲	オオサカダイクウシュウ
死を待つ人々の家	シヲマツヒトビトノイエ
日本料理	ニホンリョウリ
児童文学作家一覧	ジドウブンガクサッカイチラン
核酸	カクサン
陸上競技	リクジョウキョウギ
水泳	スイエイ
こどもの日	コドモノヒ
数学者	スウガクシャ
列車	レッシャ
子供の日	コドモノヒ
商標	ショウヒョウ
飛行機	ヒコウキ
普通列車	フツウレッシャ
しなの鉄道線	シナノテツドウセン
生殖細胞	セイショクサイボウ
神経幹細胞	シンケイカンサイボウ
作曲家	サッキョクカ
免疫学	メンエキガク
大相撲力士一覧	オオズモウリキシイチラン
投資家	トウシカ
園芸	エンゲイ
多神教	タシンキョウ
大阪城公園駅	オオサカジョウコウエンエキ
火縄銃	ヒナワジュウ
日本の仏教	ニホンノブッキョウ
光速	コウソク
科学	カガク
野良犬	ノライヌ
野犬	ヤケン
ならず者	ナラズモノ
紀元前331年	キゲンゼンサンビャクサンジュウイチネン
大阪湾	オオサカワン
鎌倉市	カマクラシ
一休宗純	イッキュウソウジュン
日本の銀行一覧	ニホンノギンコウイチラン
九州	キュウシュウ
四国	シコク
北陸地方	ホクリクチホウ
東海地方	トウカイチホウ
小豆島	ショウドシマ
淡路島	アワジシマ
大三島	オオミシマ
甲信越地方	コウシンエツチホウ
毘盧遮那仏	ビルシャナブツ
阿弥陀三尊	アミダサンゾン
京成高砂駅	ケイセイタカサゴエキ
武蔵国	ムサシノクニ
仏性	ブッショウ
三法印	サンボウイン
意味論	イミロン
軌間可変電車	キカンカヘンデンシャ
お金	オカネ
将棋棋士一覧	ショウギキシイチラン
疑似科学	ギジカガク
囲碁の記録一覧	イゴノキロクイチラン
南北朝時代	ナンボクチョウジダイ
山陽本線	サンヨウホンセン
北海道炭礦鉄道	ホッカイドウタンコウテツドウ
甲武鉄道	コウブテツドウ
核小体	カクショウタイ
声明	ショウミョウ
雅楽	ガガク
先行者	センコウシャ
日本三景	ニホンサンケイ
日本三名園	ニホンサンメイエン
同級生	ドウキュウセイ
電撃文庫	デンゲキブンコ
開発途上国	カイハツトジョウコク
新潮文庫	シンチョウブンコ
帯	オビ
特撮関連人名一覧	トクサツカンレンジンメイイチラン
重力	ジュウリョク
速度	ソクド
次元	ジゲン
公理	コウリ
筑波大学	ツクバダイガク
専用軌道	センヨウキドウ
結婚記念日	ケッコンキネンビ
政党	セイトウ
建長寺	ケンチョウジ
江ノ島電鉄線	エノシマデンテツセン
自由電子	ジユウデンシ
温泉	オンセン
横浜駅	ヨコハマエキ
大船駅	オオフナエキ
北鎌倉駅	キタカマクラエキ
鎌倉駅	カマクラエキ
さざれ石	サザレイシ
符号分割多元接続	フゴウブンカツタゲンセツゾク
新幹線	シンカンセン
信仰	シンコウ
全文検索	ゼンブンケンサク
青春18きっぷ	セイシュンジュウハチキップ
秋田新幹線	アキタシンカンセン
金貨	キンカ
銀貨	ギンカ
多体問題	タタイモンダイ
名馬一覧	メイバイチラン
構造主義	コウゾウシュギ
二酸化ケイ素	ニサンカケイソ
有機化合物	ユウキカゴウブツ
物性	ブッセイ
二酸化炭素	ニサンカタンソ
九字	クジ
占い	ウラナイ
六法	ロッポウ
閲覧	エツラン
開架式図書館	カイカシキトショカン
貸出	カシダシ
閉架式図書館	ヘイカシキトショカン
目録	モクロク
郵政記念日	ユウセイキネンビ
人権	ジンケン
利尻山	リシリザン
羅臼岳	ラウスダケ
雌阿寒岳	メアカンダケ
十勝岳	トカチダケ
幌尻岳	ポロシリダケ
岩木山	イワキサン
八甲田山	ハッコウダサン
八幡平	ハチマンタイ
岩手山	イワテサン
貴金属	キキンゾク
九字護身法	クジゴシンボウ
人類	ジンルイ
数え上げ	カゾエアゲ
行列	ギョウレツ
正方行列	セイホウギョウレツ
転置行列	テンチギョウレツ
表面	ヒョウメン
対称行列	タイショウギョウレツ
電荷	デンカ
法学者	ホウガクシャ
欠陥	ケッカン
国際民間航空機関	コクサイミンカンコウクウキカン
静止軌道	セイシキドウ
不純物	フジュンブツ
相撲界	スモウカイ
天文学者	テンモンガクシャ
西	ニシ
大名行列	ダイミョウギョウレツ
参勤交代	サンキンコウタイ
本初子午線	ホンショシゴセン
硫黄酸化物	イオウサンカブツ
四元数	シゲンスウ
鼻行類	ビコウルイ
漫才	マンザイ
原子番号	ゲンシバンゴウ
府中市	フチュウシ
工作機械	コウサクキカイ
界面	カイメン
絶対零度	ゼッタイレイド
高温超伝導	コウオンチョウデンドウ
古名	コメイ
与党	ヨトウ
野党	ヤトウ
国会議員一覧	コッカイギインイチラン
議員	ギイン
東北本線	トウホクホンセン
液体	エキタイ
液体酸素	エキタイサンソ
液体水素	エキタイスイソ
住居侵入罪	ジュウキョシンニュウザイ
不退去罪	フタイキョザイ
次元解析	ジゲンカイセキ
反例	ハンレイ
根室市	ネムロシ
湘南市	ショウナンシ
室温超伝導	シツオンチョウデンドウ
語族の一覧	ゴゾクノイチラン
冪集合	ベキシュウゴウ
将棋類の一覧	ショウギルイノイチラン
対角行列	タイカクギョウレツ
線型写像	センケイシャゾウ
行列式	ギョウレツシキ
気体	キタイ
別海町	ベツカイチョウ
事後強盗罪	ジゴゴウトウザイ
鉄道撮影	テツドウサツエイ
化石燃料	カセキネンリョウ
米	コメ
国民の休日	コクミンノキュウジツ
東府中駅	ヒガシフチュウエキ
分倍河原駅	ブバイガワラエキ
大崎駅	オオサキエキ
藤沢駅	フジサワエキ
神殿奉献	シンデンホウケン
公共財	コウキョウザイ
月の光	ツキノヒカリ
素数	ソスウ
天皇賞	テンノウショウ
写像	シャゾウ
紙飛行機	カミヒコウキ
西東京市	ニシトウキョウシ
あきる野市	アキルノシ
国家	コッカ
藤沢市	フジサワシ
講談社	コウダンシャ
火山	カザン
同位体効果	ドウイタイコウカ
放火及び失火の罪	ホウカオヨビシッカノツミ
偏光	ヘンコウ
小田原駅	オダワラエキ
桜木町駅	サクラギチョウエキ
極座標系	キョクザヒョウケイ
圧力	アツリョク
沸点	フッテン
順接	ジュンセツ
代数学の基本定理	ダイスウガクノキホンテイリ
平方剰余の相互法則	ヘイホウジョウヨノソウゴホウソク
一神教	イッシンキョウ
使徒	シト
函館本線	ハコダテホンセン
札幌市交通局	サッポロシコウツウキョク
荷電粒子	カデンリュウシ
目黒駅	メグロエキ
すべり台	スベリダイ
会社	カイシャ
国風文化	コクフウブンカ
天文台	テンモンダイ
芝	シバ
懐炉	カイロ
稲作	イナサク
原宿駅	ハラジュクエキ
代々木駅	ヨヨギエキ
品川区	シナガワク
第一勧業銀行	ダイイチカンギョウギンコウ
線型方程式系	センケイホウテイシキケイ
単射	タンシャ
境界条件	キョウカイジョウケン
位相空間	イソウクウカン
白血病	ハッケツビョウ
はさみ将棋	ハサミショウギ
癌腫	ガンシュ
近代私法の三大原則	キンダイシホウノサンダイゲンソク
遺伝子組み換え作物	イデンシクミカエサクモツ
紀勢本線	キセイホンセン
千代田区	チヨダク
国分寺駅	コクブンジエキ
西国分寺駅	ニシコクブンジエキ
音源	オンゲン
傭兵	ヨウヘイ
吸着	キュウチャク
二項演算	ニコウエンザン
新大久保駅	シンオオクボエキ
高田馬場駅	タカダノババエキ
目白駅	メジロエキ
体	シンタイ
直交	チョッコウ
内積	ナイセキ
初台駅	ハツダイエキ
映像信号	エイゾウシンゴウ
新宿区	シンジュクク
分数	ブンスウ
奥羽本線	オウウホンセン
映画用語	エイガヨウゴ
か行	カギョウ
東京国際映画祭	トウキョウコクサイエイガサイ
部分集合	ブブンシュウゴウ
内閣	ナイカク
千葉市	チバシ
政令指定都市	セイレイシテイトシ
液体窒素	エキタイチッソ
巣鴨駅	スガモエキ
駒込駅	コマゴメエキ
田端駅	タバタエキ
映画祭	エイガサイ
映画の配信媒体	エイガノハイシンバイタイ
映画史	エイガシ
江東区	コウトウク
翼	ツバサ
活動写真	カツドウシャシン
映画料金割引	エイガリョウキンワリビキ
映画の日	エイガノヒ
映画産業団体連合会	エイガサンギョウダンタイレンゴウカイ
集合論	シュウゴウロン
被疑者	ヒギシャ
押収	オウシュウ
漫画原作者	マンガゲンサクシャ
作曲家一覧	サッキョクカイチラン
日本地図	ニホンチズ
金属元素	キンゾクゲンソ
遷移元素	センイゲンソ
金剛峯寺	コンゴウブジ
核膜	カクマク
株主名簿	カブヌシメイボ
署名	ショメイ
有価証券	ユウカショウケン
数論	スウロン
町田駅	マチダエキ
さくら銀行	サクラギンコウ
野球選手	ヤキュウセンシュ
表意文字	ヒョウイモジ
表音文字	ヒョウオンモジ
公用語	コウヨウゴ
童歌	ワラベウタ
信濃川	シナノガワ
線型代数学	センケイダイスウガク
日暮里駅	ニッポリエキ
鶯谷駅	ウグイスダニエキ
江戸幕府	エドバクフ
御徒町駅	オカチマチエキ
鎌倉幕府	カマクラバクフ
交流電化	コウリュウデンカ
交流	コウリュウ
定義	テイギ
有楽町駅	ユウラクチョウエキ
新橋駅	シンバシエキ
浜松町駅	ハママツチョウエキ
田町駅	タマチエキ
月光	ゲッコウ
微分積分学の基本定理	ビブンセキブンガクノキホンテイリ
川崎駅	カワサキエキ
明	ミン
上越新幹線	ジョウエツシンカンセン
名古屋市	ナゴヤシ
密教	ミッキョウ
版権	ハンケン
新横浜駅	シンヨコハマエキ
山形新幹線	ヤマガタシンカンセン
長津田駅	ナガツタエキ
彫刻家	チョウコクカ
代々木上原駅	ヨヨギウエハラエキ
海峡線	カイキョウセン
三鷹駅	ミタカエキ
相模大野駅	サガミオオノエキ
西船橋駅	ニシフナバシエキ
卒業論文	ソツギョウロンブン
熱海駅	アタミエキ
在来線	ザイライセン
遷移	センイ
超大陸	チョウタイリク
阿蘇郡	アソグン
紀元前17世紀	キゲンゼンジュウナナセイキ
沖ノ鳥島	オキノトリシマ
南鳥島	ミナミトリシマ
亜大陸	アタイリク
代数幾何学	ダイスウキカガク
北	キタ
星雲賞	セイウンショウ
聖典	セイテン
優駿牝馬	ユウシュンヒンバ
学制改革	ガクセイカイカク
科学者	カガクシャ
デジタル加入者線	デジタルカニュウシャセン
著作物	チョサクブツ
臨床心理学	リンショウシンリガク
心理学者	シンリガクシャ
鉄族元素	テツゾクゲンソ
白銅	ハクドウ
超心理学	チョウシンリガク
競艇	キョウテイ
幕府	バクフ
八鹿町	ヨウカチョウ
豊岡市	トヨオカシ
経絡	ケイラク
科学哲学	カガクテツガク
分析哲学	ブンセキテツガク
教育関係人物一覧	キョウイクカンケイジンブツイチラン
大屋町	オオヤチョウ
関宮町	セキノミヤチョウ
学生寮	ガクセイリョウ
映画の著作物	エイガノチョサクブツ
抗うつ薬	コウウツヤク
城崎町	キノサキチョウ
臭素	シュウソ
竹野町	タケノチョウ
宮城野区	ミヤギノク
倶知安町	クッチャンチョウ
動的リンク	ドウテキリンク
漢方薬	カンポウヤク
洗濯機	センタクキ
赤外線	セキガイセン
日本映画	ニホンエイガ
原作	ゲンサク
慣用句	カンヨウク
衛星電話	エイセイデンワ
ご当地映画	ゴトウチエイガ
週	シュウ
岸和田市	キシワダシ
琵琶湖	ビワコ
炭酸塩	タンサンエン
奇数	キスウ
偶数	グウスウ
名前空間	ナマエクウカン
加速度	カソクド
日本海中部地震	ニホンカイチュウブジシン
体積	タイセキ
計算化学	ケイサンカガク
半島	ハントウ
相撲部屋	スモウベヤ
大相撲	オオズモウ
御茶ノ水駅	オチャノミズエキ
判例	ハンレイ
粘土団子	ネンドダンゴ
職業	ショクギョウ
半群	ハングン
近代音楽	キンダイオンガク
冷蔵庫	レイゾウコ
収容分類級	シュウヨウブンルイキュウ
安田記念	ヤスダキネン
家庭の電化	カテイノデンカ
海水浴場	カイスイヨクジョウ
延長戦	エンチョウセン
株主総会	カブヌシソウカイ
数学定数	スウガクテイスウ
超越数	チョウエツスウ
代数的数	ダイスウテキスウ
国連軍	コクレングン
発電機	ハツデンキ
新選組	シンセングミ
直線	チョクセン
線分	センブン
佐倉市	サクラシ
十六元数	ジュウロクゲンスウ
生物工学	セイブツコウガク
課金	カキン
岩波文庫	イワナミブンコ
古生物	コセイブツ
歯科	シカ
論理和	ロンリワ
論理積	ロンリセキ
黒川温泉	クロカワオンセン
南小国町	ミナミオグニマチ
阿蘇温泉郷	アソオンセンキョウ
本能寺の変	ホンノウジノヘン
化学者	カガクシャ
排他的論理和	ハイタテキロンリワ
駒場東大前駅	コマバトウダイマエエキ
金管楽器	キンカンガッキ
国際連合大量破壊兵器廃棄特別委員会	コクサイレンゴウタイリョウハカイヘイキハイキトクベツイインカイ
京成上野駅	ケイセイウエノエキ
陰核	インカク
酸	サン
馬橋駅	マバシエキ
幸谷駅	コウヤエキ
小金城趾駅	コガネジョウシエキ
鰭ヶ崎駅	ヒレガサキエキ
流山駅	ナガレヤマエキ
池田屋事件	イケダヤジケン
新松戸駅	シンマツドエキ
最大公約数	サイダイコウヤクスウ
最小公倍数	サイショウコウバイスウ
歯科技工士	シカギコウシ
博物館動物園駅	ハクブツカンドウブツエンエキ
化合物	カゴウブツ
離散数学	リサンスウガク
混合物	コンゴウブツ
公的資金	コウテキシキン
最短経路問題	サイタンケイロモンダイ
化学の分野一覧	カガクノブンヤイチラン
星座	セイザ
誤差	ゴサ
情報理論	ジョウホウリロン
東西線	トウザイセン
斬鉄剣	ザンテツケン
箱根町	ハコネマチ
橋	ハシ
塩基	エンキ
定量的研究	テイリョウテキケンキュウ
機械要素	キカイヨウソ
野球場	ヤキュウジョウ
施設	シセツ
経営工学	ケイエイコウガク
蒸気機関	ジョウキキカン
蒸気機関車	ジョウキキカンシャ
長野新幹線	ナガノシンカンセン
軍事著作家一覧	グンジチョサクカイチラン
音更町	オトフケチョウ
人名用漢字	ジンメイヨウカンジ
当用漢字	トウヨウカンジ
原動機	ゲンドウキ
近東	キントウ
分配法則	ブンパイホウソク
念仏平和主義	ネンブツヘイワシュギ
神楽坂駅	カグラザカエキ
内房線	ウチボウセン
大貫駅	オオヌキエキ
千葉みなと駅	チバミナトエキ
片仮名	カタカナ
新木場駅	シンキバエキ
奥多摩駅	オクタマエキ
東松戸駅	ヒガシマツドエキ
方南町駅	ホウナンチョウエキ
光が丘駅	ヒカリガオカエキ
第7族元素	ダイナナゾクゲンソ
恩田駅	オンダエキ
相振り飛車	アイフリビシャ
京王八王子駅	ケイオウハチオウジエキ
帝王賞	テイオウショウ
住宅	ジュウタク
生産計画	セイサンケイカク
宝塚記念	タカラヅカキネン
中小企業診断士	チュウショウキギョウシンダンシ
阿弥陀如来	アミダニョライ
早稲田駅	ワセダエキ
紀元前13世紀	キゲンゼンジュウサンセイキ
相変化	ソウヘンカ
灌仏会	カンブツエ
如来	ニョライ
歌劇	カゲキ
葛西駅	カサイエキ
和歌山線	ワカヤマセン
天外魔境	テンガイマキョウ
文部省	モンブショウ
外房線	ソトボウセン
自己相似	ジコソウジ
地球環境問題	チキュウカンキョウモンダイ
理解社会学	リカイシャカイガク
貫	カン
古典派音楽	コテンハオンガク
計算可能性理論	ケイサンカノウセイリロン
最適化問題	サイテキカモンダイ
信者	シンジャ
楠賞全日本アラブ優駿	クスノキショウゼンニホンアラブユウシュン
山口市	ヤマグチシ
自然対数	シゼンタイスウ
練習曲	レンシュウキョク
黄金比	オウゴンヒ
銭貨	センカ
特装車	トクソウシャ
量子	リョウシ
小陰唇	ショウインシン
萩市	ハギシ
周南市	シュウナンシ
下松市	クダマツシ
帝紀	テイキ
整数計画問題	セイスウケイカクモンダイ
地金型金貨	ジガネガタキンカ
商学	ショウガク
政治体制	セイジタイセイ
地政学	チセイガク
津市	ツシ
京急	ケイキュウ
光明	コウミョウ
練馬区	ネリマク
板橋区	イタバシク
一分金	イチブキン
慈照寺	ジショウジ
新川崎駅	シンカワサキエキ
いろは歌	イロハウタ
重商主義	ジュウショウシュギ
一朱金	イッシュキン
品切重版未定	シナギレジュウハンミテイ
鉄道旅行	テツドウリョコウ
完乗	カンジョウ
背圧	ハイアツ
海浜幕張駅	カイヒンマクハリエキ
棋士	キシ
棋戦	キセン
中距離走	チュウキョリソウ
四街道市	ヨツカイドウシ
二朱金	ニシュキン
二分金	ニブキン
大名	ダイミョウ
識字	シキジ
符号理論	フゴウリロン
算術符号	サンジュツフゴウ
国際連合大学	コクサイレンゴウダイガク
国立国会図書館	コクリツコッカイトショカン
大和時代	ヤマトジダイ
真空	シンクウ
真空計	シンクウケイ
希薄磁性半導体	キハクジセイハンドウタイ
折田先生像	オリタセンセイゾウ
湘南電車	ショウナンデンシャ
湘南	ショウナン
能登空港	ノトクウコウ
わかち書き	ワカチガキ
七姫物語	ナナヒメモノガタリ
大東急	ダイトウキュウ
川越線	カワゴエセン
重力加速度	ジュウリョクカソクド
八千代緑が丘駅	ヤチヨミドリガオカエキ
議院内閣制	ギインナイカクセイ
逆元	ギャクゲン
額田郡	ヌカタグン
海老名駅	エビナエキ
一分銀	イチブギン
共観福音書	キョウカンフクインショ
高松塚古墳	タカマツヅカコフン
題目	ダイモク
悪人正機	アクニンショウキ
念仏	ネンブツ
本地垂迹	ホンジスイジャク
割礼	カツレイ
南半球	ミナミハンキュウ
法然	ホウネン
十八番	オハコ
衆議院議員一覧	シュウギインギインイチラン
日経平均株価	ニッケイヘイキンカブカ
浄土三部経	ジョウドサンブキョウ
経絡秘孔	ケイラクヒコウ
赤羽線	アカバネセン
赤羽駅	アカバネエキ
板橋駅	イタバシエキ
整数環	セイスウカン
同値関係	ドウチカンケイ
長さ	ナガサ
魔法使い	マホウツカイ
平面	ヘイメン
小判	コバン
短距離走	タンキョリソウ
長距離走	チョウキョリソウ
御三家	ゴサンケ
成城学園前駅	セイジョウガクエンマエエキ
茨木駅	イバラキエキ
個人旅行	コジンリョコウ
沖縄国際海洋博覧会	オキナワコクサイカイヨウハクランカイ
丁銀	チョウギン
国際通貨基金	コクサイツウカキキン
視聴率	シチョウリツ
世界銀行	セカイギンコウ
戯曲	ギキョク
豆板銀	マメイタギン
両	リョウ
数学の競技	スウガクノキョウギ
状態数	ジョウタイスウ
尾張藩	オワリハン
走幅跳	ハシリハバトビ
鉄道模型	テツドウモケイ
三段跳	サンダントビ
砲丸投	ホウガンナゲ
岐阜市	ギフシ
鶴川駅	ツルカワエキ
東海大学前駅	トウカイダイガクマエエキ
武蔵境駅	ムサシサカイエキ
居飛車	イビシャ
障害走	ショウガイソウ
競泳	キョウエイ
自由形	ジユウガタ
平泳ぎ	ヒラオヨギ
潜水泳法	センスイエイホウ
玄宗	ゲンソウ
太宗	タイソウ
振り飛車	フリビシャ
番勝負	バンショウブ
竜王戦	リュウオウセン
猪苗代駅	イナワシロエキ
猪苗代町	イナワシロマチ
川桁駅	カワゲタエキ
新人類	シンジンルイ
関都駅	セキトエキ
猪苗代湖畔駅	イナワシロコハンエキ
中山宿駅	ナカヤマジュクエキ
磐梯熱海駅	バンダイアタミエキ
安子ケ島駅	アコガシマエキ
喜久田駅	キクタエキ
翁島駅	オキナシマエキ
磐梯町駅	バンダイマチエキ
東長原駅	ヒガシナガハラエキ
広田駅	ヒロタエキ
戸塚駅	トツカエキ
大井町駅	オオイマチエキ
東神奈川駅	ヒガシカナガワエキ
京浜急行線	ケイヒンキュウコウセン
会津若松駅	アイヅワカマツエキ
府中本町駅	フチュウホンマチエキ
愛称	アイショウ
稲毛海岸駅	イナゲカイガンエキ
吉祥寺駅	キチジョウジエキ
南鐐二朱銀	ナンリョウニシュギン
五匁銀	ゴモンメギン
有事法制	ユウジホウセイ
高井戸駅	タカイドエキ
狭山市	サヤマシ
稲荷山公園駅	イナリヤマコウエンエキ
狭山市駅	サヤマシエキ
入間市駅	イルマシエキ
政策科学	セイサクカガク
失業	シツギョウ
労働組合	ロウドウクミアイ
年金	ネンキン
社会政策	シャカイセイサク
曇鸞	ドンラン
善導	ゼンドウ
健康保険	ケンコウホケン
国際関係	コクサイカンケイ
国際関係論	コクサイカンケイロン
新機能主義	シンキノウシュギ
片瀬江ノ島駅	カタセエノシマエキ
国連開発の十年	コクレンカイハツノジュウネン
国際連合事務局	コクサイレンゴウジムキョク
営団	エイダン
練馬駅	ネリマエキ
役職	ヤクショク
虚数	キョスウ
聖蹟桜ヶ丘駅	セイセキサクラガオカエキ
慣性	カンセイ
菩薩	ボサツ
法用語一覧	ホウヨウゴイチラン
磐越西線	バンエツサイセン
新津駅	ニイツエキ
不可分債務	フカブンサイム
独立	ドクリツ
行政罰	ギョウセイバツ
相模線	サガミセン
取消訴訟	トリケシソショウ
自由裁量処分	ジユウサイリョウショブン
行政行為	ギョウセイコウイ
行政代執行	ギョウセイダイシッコウ
行政上の強制執行	ギョウセイジョウノキョウセイシッコウ
高崎線	タカサキセン
豊島園駅	トシマエンエキ
責任主義	セキニンシュギ
明確性の原則	メイカクセイノゲンソク
未遂	ミスイ
法益	ホウエキ
文書偽造の罪	ブンショギゾウノツミ
山	ヤマ
多項式時間	タコウシキジカン
多項式	タコウシキ
戦時買収私鉄	センジバイシュウシテツ
川越市	カワゴエシ
阪和電気鉄道	ハンワデンキテツドウ
技術的行政学	ギジュツテキギョウセイガク
不逮捕特権	フタイホトッケン
徳川宗家	トクガワソウケ
比例原則	ヒレイゲンソク
執行罰	シッコウバツ
賃貸借	チンタイシャク
公務員職権濫用罪	コウムインショッケンランヨウザイ
通貨偽造の罪	ツウカギゾウノツミ
投資関数	トウシカンスウ
無差別曲線	ムサベツキョクセン
暫定予算	ザンテイヨサン
京成西船駅	ケイセイニシフナエキ
資格任用制	シカクニンヨウセイ
一等車	イットウシャ
紀元前2世紀	キゲンゼンニセイキ
速さ	ハヤサ
多摩動物公園駅	タマドウブツコウエンエキ
双子素数	フタゴソスウ
遣唐使	ケントウシ
戸倉町	トグラマチ
上田市	ウエダシ
君主	クンシュ
合成数	ゴウセイスウ
空集合	クウシュウゴウ
法律の留保	ホウリツノリュウホ
禁止	キンシ
認可	ニンカ
固定小数点数	コテイショウスウテンスウ
地域主義	チイキシュギ
称名	ショウミョウ
資本	シホン
完全数	カンゼンスウ
現代音楽	ゲンダイオンガク
行政国家	ギョウセイコッカ
公開市場操作	コウカイシジョウソウサ
第四次中東戦争	ダイヨジチュウトウセンソウ
川越駅	カワゴエエキ
稲毛駅	イナゲエキ
寸	スン
日米修好通商条約	ニチベイシュウコウツウショウジョウヤク
三線軌条	サンセンキジョウ
管楽器	カンガッキ
西武有楽町線	セイブユウラクチョウセン
岩石学	ガンセキガク
新宿西口駅	シンジュクニシグチエキ
浄土宗	ジョウドシュウ
五大明王	ゴダイミョウオウ
気温	キオン
世界水泳選手権	セカイスイエイセンシュケン
世界陸上競技選手権大会	セカイリクジョウキョウギセンシュケンタイカイ
寛永通宝	カンエイツウホウ
尊王論	ソンノウロン
攘夷論	ジョウイロン
文	ブン
利益団体	リエキダンタイ
埼玉高速鉄道線	サイタマコウソクテツドウセン
痴漢	チカン
補償	ホショウ
信義誠実の原則	シンギセイジツノゲンソク
色空間	イロクウカン
平地競走	ヘイチキョウソウ
ばんえい競走	バンエイキョウソウ
四日市市	ヨッカイチシ
導出原理	ドウシュツゲンリ
行政裁量	ギョウセイサイリョウ
七尾市	ナナオシ
旧暦	キュウレキ
国民の祝日	コクミンノシュクジツ
祝日	シュクジツ
空気	クウキ
往生	オウジョウ
被告	ヒコク
用不用説	ヨウフヨウセツ
尺	シャク
橋本駅	ハシモトエキ
多摩境駅	タマサカイエキ
丈	ジョウ
間	ケン
因果	インガ
佐渡郡	サドグン
商法総則	ショウホウソウソク
湘南電気鉄道	ショウナンデンキテツドウ
西大井駅	ニシオオイエキ
東戸塚駅	ヒガシトツカエキ
鍵盤	ケンバン
中山大障害	ナカヤマダイショウガイ
駅伝競走	エキデンキョウソウ
因縁	インネン
ばんえい記念	バンエイキネン
浜松駅	ハママツエキ
天保通宝	テンポウツウホウ
和製英語	ワセイエイゴ
電流	デンリュウ
用宗駅	モチムネエキ
由比駅	ユイエキ
文久永宝	ブンキュウエイホウ
錦糸町駅	キンシチョウエキ
両国駅	リョウゴクエキ
浅草橋駅	アサクサバシエキ
水道橋駅	スイドウバシエキ
飯田橋駅	イイダバシエキ
信濃町駅	シナノマチエキ
磁性	ジセイ
秋華賞	シュウカショウ
理想気体の状態方程式	リソウキタイノジョウタイホウテイシキ
日支事変	ニッシジヘン
沖積平野	チュウセキヘイヤ
散乱理論	サンランリロン
反強磁性	ハンキョウジセイ
編集	ヘンシュウ
起承転結	キショウテンケツ
世界名作劇場	セカイメイサクゲキジョウ
東村山駅	ヒガシムラヤマエキ
所沢市	トコロザワシ
三昧	サンマイ
永楽通宝	エイラクツウホウ
公開鍵暗号	コウカイカギアンゴウ
越後湯沢駅	エチゴユザワエキ
真理値	シンリチ
南柏駅	ミナミカシワエキ
散乱	サンラン
石	イシ
計算機工学	ケイサンキコウガク
看護学	カンゴガク
亀有駅	カメアリエキ
墨田区	スミダク
字句	ジク
大阪	オオサカ
天保暦	テンポウレキ
尺貫法	シャッカンホウ
名古屋駅	ナゴヤエキ
四法印	シホウイン
大和路線	ヤマトジセン
和光市駅	ワコウシエキ
仏典	ブッテン
軽井沢駅	カルイザワエキ
阿羅漢	アラカン
第5の力	ダイゴノチカラ
三種の浄肉	サンシュノジョウニク
荻窪駅	オギクボエキ
和讃	ワサン
大学校	ダイガッコウ
対数	タイスウ
指数関数	シスウカンスウ
成東駅	ナルトウエキ
患者	カンジャ
数学的帰納法	スウガクテキキノウホウ
三角関数	サンカクカンスウ
逆数	ギャクスウ
虚数単位	キョスウタンイ
蓮如	レンニョ
連想配列	レンソウハイレツ
会戦	カイセン
根本分裂	コンポンブンレツ
政党制	セイトウセイ
僧	ソウ
伝統医学	デントウイガク
戦国時代	センゴクジダイ
初等関数	ショトウカンスウ
飛鳥時代	アスカジダイ
全日本アラブ大賞典	ゼンニホンアラブダイショウテン
教育漢字	キョウイクカンジ
数値解析	スウチカイセキ
俘囚	フシュウ
出羽国	デワノクニ
陸奥国	ムツノクニ
周期関数	シュウキカンスウ
倶会一処	クエイッショ
盂蘭盆会	ウラボンエ
石城国	イワキノクニ
石背国	イワセノクニ
常陸国	ヒタチノクニ
命令	メイレイ
徳川御三家	トクガワゴサンケ
越後国	エチゴノクニ
越中国	エッチュウノクニ
座標	ザヒョウ
阪東橋駅	バンドウバシエキ
能登国	ノトノクニ
隣接行列	リンセツギョウレツ
常磁性	ジョウジセイ
一筆書き	ヒトフデガキ
飛車	ヒシャ
角行	カクギョウ
金将	キンショウ
銀将	ギンショウ
桂馬	ケイマ
燃焼	ネンショウ
香車	キョウシャ
東大阪市	ヒガシオオサカシ
温泉卵	オンセンタマゴ
頤和園	イワエン
西千葉駅	ニシチバエキ
新検見川駅	シンケミガワエキ
幕張駅	マクハリエキ
幕張本郷駅	ケイセイマクハリホンゴウエキ
東船橋駅	ヒガシフナバシエキ
集英社	シュウエイシャ
小学館	ショウガクカン
散文	サンブン
加賀国	カガノクニ
過給機	カキュウキ
盲学校	モウガッコウ
博多南線	ハカタミナミセン
越前国	エチゼンノクニ
長崎本線	ナガサキホンセン
若狭国	ワカサノクニ
佐渡国	サドノクニ
防衛機制	ボウエイキセイ
安房国	アワノクニ
三ノ輪橋停留場	ミノワバシテイリュウジョウ
三ノ輪駅	ミノワエキ
西新井駅	ニシアライエキ
大師前駅	ダイシマエエキ
下板橋駅	シモイタバシエキ
足利将軍家	アシカガショウグンケ
明大前駅	メイダイマエエキ
地中海	チチュウカイ
浦島太郎	ウラシマタロウ
桃太郎	モモタロウ
正一教	ショウイツキョウ
朝霞台駅	アサカダイエキ
天体工場	テンタイコウジョウ
物理単位	ブツリタンイ
下野国	シモツケノクニ
上野	ウエノ
快速列車	カイソクレッシャ
準急列車	ジュンキュウレッシャ
信濃国	シナノノクニ
諏方国	スワノクニ
仏滅	ブツメツ
急行列車	キュウコウレッシャ
新快速	シンカイソク
諸法実相	ショホウジッソウ
急行	キュウコウ
定期乗車券	テイキジョウシャケン
休暇村	キュウカムラ
修学旅行	シュウガクリョコウ
入滅	ニュウメツ
海洋冒険小説	カイヨウボウケンショウセツ
美濃国	ミノノクニ
教育課程	キョウイクカテイ
近江国	オウミノクニ
尾道市	オノミチシ
日本天文学会	ニホンテンモンガッカイ
田原市	タハラシ
電気録音	デンキロクオン
白金高輪駅	シロカネタカナワエキ
赤羽岩淵駅	アカバネイワブチエキ
学年別漢字配当表	ガクネンベツカンジハイトウヒョウ
相模国	サガミノクニ
豊田商事事件	トヨタショウジジケン
甲斐国	カイノクニ
埼玉りそな銀行	サイタマリソナギンコウ
富士銀行	フジギンコウ
日本興業銀行	ニッポンコウギョウギンコウ
横田飛行場	ヨコタヒコウジョウ
箱根海賊船	ハコネカイゾクセン
遼	リョウ
伊豆国	イズノクニ
駿河国	スルガノクニ
田沢湖町	タザワコマチ
地下鉄博物館	チカテツハクブツカン
電算写植	デンサンシャショク
写真植字機	シャシンショクジキ
競馬場	ケイバジョウ
柔道家一覧	ジュウドウカイチラン
総和	ソウワ
御三卿	ゴサンキョウ
還相回向	ゲンソウエコウ
柏市	カシワシ
一橋徳川家	ヒトツバシトクガワケ
往相回向	オウソウエコウ
清水徳川家	シミズトクガワケ
田安徳川家	タヤストクガワケ
越前松平家	エチゼンマツダイラケ
会津松平家	アイヅマツダイラケ
羊肉	ヨウニク
利根川	トネガワ
柏駅	カシワエキ
豊四季駅	トヨシキエキ
新柏駅	シンカシワエキ
増尾駅	マスオエキ
逆井駅	サカサイエキ
生きている化石	イキテイルカセキ
仕事関数	シゴトカンスウ
超古代文明	チョウコダイブンメイ
整数列	セイスウレツ
十五年戦争	ジュウゴネンセンソウ
新大塚駅	シンオオツカエキ
魔方陣	マホウジン
単行本	タンコウボン
暦注	レキチュウ
茅場町駅	カヤバチョウエキ
貴族院	キゾクイン
閩語	ビンゴ
選挙権	センキョケン
漢	カン
伊勢国	イセノクニ
南与野駅	ミナミヨノエキ
武蔵浦和駅	ムサシウラワエキ
野方駅	ノガタエキ
肺炎	ハイエン
雉	キジ
熊谷駅	クマガヤエキ
台湾原住民	タイワンゲンジュウミン
一輪車	イチリンシャ
志摩国	シマノクニ
麒麟	キリン
肉食動物	ニクショクドウブツ
国道	コクドウ
一般国道	イッパンコクドウ
盆踊り	ボンオドリ
黒い雨	クロイアメ
抱き枕	ダキマクラ
北柏駅	キタカシワエキ
常磐緩行線	ジョウバンカンコウセン
江曽島駅	エソジマエキ
おもちゃのまち駅	オモチャノマチエキ
子役	コヤク
西郷星	サイゴウボシ
慈悲	ジヒ
鮫島事件	サメジマジケン
磁場	ジバ
存思	ソンシ
洞天福地	ドウテンフクチ
常識	ジョウシキ
金太郎	キンタロウ
半魚人	ハンギョジン
青梅線	オウメセン
説話	セツワ
土木工学	ドボクコウガク
伊賀国	イガノクニ
二十四史	ニジュウシシ
東武宇都宮駅	トウブウツノミヤエキ
二十四節気	ニジュウシセッキ
社会科学	シャカイカガク
行動科学	コウドウカガク
総合科学	ソウゴウカガク
災害	サイガイ
立春	リッシュン
雨水	ウスイ
啓蟄	ケイチツ
春分	シュンブン
五声	ゴセイ
川中島の戦い	カワナカジマノタタカイ
昆虫	コンチュウ
首都高速道路	シュトコウソクドウロ
人力発電	ジンリキハツデン
西多摩郡	ニシタマグン
瑞穂町	ミズホマチ
日光線	ニッコウセン
宇都宮駅	ウツノミヤエキ
現代社会	ゲンダイシャカイ
紀伊国	キイノクニ
淡路国	アワジノクニ
七十二候	シチジュウニコウ
酒税法	シュゼイホウ
地質時代	チシツジダイ
人海戦術	ジンカイセンジュツ
太陽年	タイヨウネン
恒星年	コウセイネン
顕微鏡	ケンビキョウ
鶴田駅	ツルタエキ
納豆	ナットウ
西武秩父線	セイブチチブセン
豆腐	トウフ
湯豆腐	ユドウフ
多摩動物公園	タマドウブツコウエン
阿波国	アワノクニ
清明	セイメイ
穀雨	コクウ
立夏	リッカ
小満	ショウマン
芒種	ボウシュ
小暑	ショウショ
大暑	タイショ
被選挙権	ヒセンキョケン
こどもの国駅	コドモノクニエキ
お好み焼き	オコノミヤキ
ときわ台駅	トキワダイエキ
ひばりヶ丘駅	ヒバリガオカエキ
新板橋駅	シンイタバシエキ
西巣鴨駅	ニシスガモエキ
徳間書店	トクマショテン
土佐国	トサノクニ
伊予国	イヨノクニ
取手市	トリデシ
口裂け女	クチサケオンナ
東北地方の道路一覧	トウホクチホウノドウロイチラン
南北問題	ナンボクモンダイ
累積債務問題	ルイセキサイムモンダイ
中部地方の道路一覧	チュウブチホウノドウロイチラン
門徒	モント
中国地方の道路一覧	チュウゴクチホウノドウロイチラン
四国地方の道路一覧	シコクチホウノドウロイチラン
III-V族半導体	サンゴゾクハンドウタイ
II-VI族半導体	ニロクゾクハンドウタイ
約数	ヤクスウ
素因数分解	ソインスウブンカイ
潜水	センスイ
電気伝導	デンキデンドウ
超流動	チョウリュウドウ
日本旅行	ニホンリョコウ
有効質量	ユウコウシツリョウ
丹波国	タンバノクニ
鎌ケ谷市	カマガヤシ
太極拳	タイキョクケン
紀元前322年	キゲンゼンサンビャクニジュウニネン
華族	カゾク
和歌	ワカ
侯爵	コウシャク
季語	キゴ
発散定理	ハッサンテイリ
武蔵小杉駅	ムサシコスギエキ
成田線	ナリタセン
宮古市	ミヤコシ
山城国	ヤマシロノクニ
塩酸	エンサン
国字	コクジ
紀元前323年	キゲンゼンサンビャクニジュウサンネン
III-V族化合物	サンゴゾクカゴウブツ
強相関電子系	キョウソウカンデンシケイ
連分数	レンブンスウ
学習塾	ガクシュウジュク
月遅れ	ツキオクレ
新暦	シンレキ
枚方市	ヒラカタシ
交野市	カタノシ
三枚おろし	サンマイオロシ
三杯酢	サンバイズ
屋久島	ヤクシマ
塩揉み	シオモミ
塩茹で	シオユデ
湯煎	ユセン
下拵え	シタゴシラエ
皇族	コウゾク
神戸空港	コウベクウコウ
貨客船	カキャクセン
秋雨	アキサメ
循環型社会	ジュンカンガタシャカイ
廃棄物等	ハイキブツトウ
社会主義	シャカイシュギ
津軽海峡線	ツガルカイキョウセン
鏡石町	カガミイシマチ
専門雑誌	センモンザッシ
棋聖	キセイ
排出者責任	ハイシュツシャセキニン
王子駅	オウジエキ
丹後国	タンゴノクニ
公明党	コウメイトウ
推理作家	スイリサッカ
寿命	ジュミョウ
有毒植物	ユウドクショクブツ
再使用	サイシヨウ
薄膜	ハクマク
東北縦貫自動車道	トウホクジュウカンジドウシャドウ
紙型	シケイ
解剖学	カイボウガク
中綴じ	ナカトジ
略語	リャクゴ
江戸湾	エドワン
聖徳太子	ショウトクタイシ
日本推理作家協会賞	ニホンスイリサッカキョウカイショウ
中洲川端駅	ナカスカワバタエキ
福岡空港駅	フクオカクウコウエキ
姪浜駅	メイノハマエキ
福岡市交通局	フクオカシコウツウキョク
人形劇	ニンギョウゲキ
愛情表現	アイジョウヒョウゲン
鹿苑寺	ロクオンジ
新潮社	シンチョウシャ
戦国大名	センゴクダイミョウ
電力	デンリョク
五味	ゴミ
特別快速	トクベツカイソク
避妊	ヒニン
神戸大学	コウベダイガク
旧石器時代	キュウセッキジダイ
紀元前540年	キゲンゼンゴヒャクヨンジュウネン
鳩	ハト
勃起	ボッキ
本八幡駅	モトヤワタエキ
馬喰横山駅	バクロヨコヤマエキ
幹線	カンセン
二酸化硫黄	ニサンカイオウ
総合格闘技	ソウゴウカクトウギ
銀座一丁目駅	ギンザイッチョウメエキ
地球物理学	チキュウブツリガク
思想家	シソウカ
年賀状	ネンガジョウ
紀元前543年	キゲンゼンゴヒャクヨンジュウサンネン
紀元前312年	キゲンゼンサンビャクジュウネン
伯耆国	ホウキノクニ
普通乗車券	フツウジョウシャケン
命名権	メイメイケン
XMODEM	エックスモデム
所沢駅	トコロザワエキ
豊橋創造大学	トヨハシソウゾウダイガク
東小金井駅	ヒガシコガネイエキ
武蔵小金井駅	ムサシコガネイエキ
押上駅	オシアゲエキ
北千住駅	キタセンジュエキ
国府津駅	コウヅエキ
綾瀬駅	アヤセエキ
菊名駅	キクナエキ
多摩川駅	タマガワエキ
熱帯夜	ネッタイヤ
蚊取り線香	カトリセンコウ
電気回路	デンキカイロ
分散型	ブンサンガタ
集中型	シュウチュウガタ
瑕疵	カシ
戦車	センシャ
電気材料	デンキザイリョウ
電力流通	デンリョクリュウツウ
大東文化大学	ダイトウブンカダイガク
旧世界	キュウセカイ
中山道	ナカセンドウ
駅弁	エキベン
航空母艦	コウクウボカン
横浜国立大学	ヨコハマコクリツダイガク
国体	コクタイ
夜行列車	ヤコウレッシャ
原子力空母	ゲンシリョククウボ
発光	ハッコウ
日南線	ニチナンセン
宮崎空港線	ミヤザキクウコウセン
仙台市交通局	センダイシコウツウキョク
発電	ハツデン
くりはら田園鉄道線	クリハラデンエンテツドウセン
水上機	スイジョウキ
総合研究大学院大学	ソウゴウケンキュウダイガクインダイガク
高規格幹線道路	コウキカクカンセンドウロ
複葉機	フクヨウキ
守護代	シュゴダイ
捕鯨問題	ホゲイモンダイ
肝試し	キモダメシ
立秋	リッシュウ
処暑	ショショ
白露	ハクロ
秋分	シュウブン
部屋	ヘヤ
電気計測工学	デンキケイソクコウガク
山崎の戦い	ヤマザキノタタカイ
看護大学	カンゴダイガク
脚本家	キャクホンカ
真庭郡	マニワグン
岡山市	オカヤマシ
中世西洋音楽	チュウセイセイヨウオンガク
西武球場前駅	セイブキュウジョウマエエキ
晴明神社	セイメイジンジャ
多摩湖駅	タマコエキ
出雲国	イズモノクニ
隠岐国	オキノクニ
日本の道100選	ニホンノミチヒャクセン
燃料	ネンリョウ
常磐快速線	ジョウバンカイソクセン
金光教	コンコウキョウ
按摩	アンマ
変電	ヘンデン
四條畷市	シジョウナワテシ
座頭	ザトウ
院政	インセイ
寒露	カンロ
霜降	ソウコウ
立冬	リットウ
小雪	ショウセツ
大雪	タイセツ
小寒	ショウカン
大寒	ダイカン
春	ハル
冬	フユ
四季	シキ
男爵	ダンシャク
送電	ソウデン
配電	ハイデン
内燃力発電	ナイネンリョクハツデン
仙石線	センセキセン
一切皆苦	イッサイカイク
欠史十代	ケッシジュウダイ
土用	ドヨウ
綱引き	ツナヒキ
玉入れ	タマイレ
土用の丑の日	ドヨウノウシノヒ
政策研究大学院大学	セイサクケンキュウダイガクインダイガク
軍事技術	グンジギジュツ
核分裂炉	カクブンレツロ
火災	カサイ
日焼け	ヒヤケ
選日	センジツ
兵家	ヘイカ
水力発電	スイリョクハツデン
儒学者	ジュガクシャ
儒学者一覧	ジュガクシャイチラン
発電設備の運用	ハツデンセツビノウンヨウ
高崎競馬場	タカサキケイバジョウ
東武本線	トウブホンセン
行田市駅	ギョウダシエキ
電力系統	デンリョクケイトウ
脚本家一覧	キャクホンカイチラン
脚本	キャクホン
原画	ゲンガ
建築	ケンチク
花見	ハナミ
第二量子化	ダイニリョウシカ
水道管	スイドウカン
大覚寺統	ダイカクジトウ
持明院統	ジミョウイントウ
素粒子物理学	ソリュウシブツリガク
水道	スイドウ
上水道	ジョウスイドウ
環境	カンキョウ
石見国	イワミノクニ
兵器	ヘイキ
南多摩駅	ミナミタマエキ
整備新幹線	セイビシンカンセン
北陸新幹線	ホクリクシンカンセン
福井藩	フクイハン
中村区	ナカムラク
常滑市	トコナメシ
安居院唱導教団	アグイショウドウキョウダン
五胡	ゴコ
白泉社	ハクセンシャ
胡	コ
魏晋南北朝時代	ギシンナンボクチョウジダイ
金沢市	カナザワシ
由仁町	ユニチョウ
計画のみに終わった兵器	ケイカクノミニオワッタヘイキ
金沢駅	カナザワエキ
電力回路	デンリョクカイロ
音節文字	オンセツモジ
播磨国	ハリマノクニ
信越本線	シンエツホンセン
直流回路	チョクリュウカイロ
超特急	チョウトッキュウ
変電所	ヘンデンショ
列車種別	レッシャシュベツ
二百十日	ニヒャクトオカ
越智松平家	オチマツダイラケ
共通語	キョウツウゴ
軽便鉄道	ケイベンテツドウ
南海本線	ナンカイホンセン
肝吸い	キモスイ
雑節	ザッセツ
英語圏	エイゴケン
訳経史区分	ヤッキョウシクブン
暦法	レキホウ
日本海縦貫線	ニホンカイジュウカンセン
市電	シデン
晴れ	ハレ
曇り	クモリ
準特急	ジュントッキュウ
急行券	キュウコウケン
社日	シャニチ
切り札	キリフダ
彼岸	ヒガン
峠の釜めし	トウゲノカマメシ
兵庫県南部地震	ヒョウゴケンナンブジシン
初午	ハツウマ
北綾瀬駅	キタアヤセエキ
東浦和駅	ヒガシウラワエキ
鳩ヶ谷駅	ハトガヤエキ
川口元郷駅	カワグチモトゴウエキ
新井宿駅	アライジュクエキ
正三角形	セイサンカクケイ
備前国	ビゼンノクニ
美作国	ミマサカノクニ
三伏	サンプク
浜寺公園駅	ハマデラコウエンエキ
北野田駅	キタノダエキ
玉川大学	タマガワダイガク
こどもの国	コドモノクニ
益子焼	マシコヤキ
太陽党	タイヨウトウ
善意	ゼンイ
大手私鉄	オオテシテツ
準大手私鉄	ジュンオオテシテツ
安土桃山時代	アヅチモモヤマジダイ
東京六大学野球連盟	トウキョウロクダイガクヤキュウレンメイ
山田線	ヤマダセン
距離	キョリ
孔門十哲	コウモンジッテツ
大韓航空機爆破事件	ダイカンコウクウキバクハジケン
行列の基本変形	ギョウレツノキホンヘンケイ
府中競馬正門前駅	フチュウケイバセイモンマエエキ
名古屋飛行場	ナゴヤヒコウジョウ
太陽電池	タイヨウデンチ
紀元前509年	キゲンゼンゴヒャクキュウネン
備中国	ビッチュウノクニ
駆逐戦車	クチクセンシャ
重陽	チョウヨウ
烏山線	カラスヤマセン
備後国	ビンゴノクニ
安芸国	アキノクニ
周防国	スオウノクニ
千曲市	チクマシ
長崎駅	ナガサキエキ
浦上駅	ウラカミエキ
西浦上駅	ニシウラカミエキ
中つ国	ナカツクニ
名古屋市営地下鉄	ナゴヤシエイチカテツ
燃料電池	ネンリョウデンチ
保安装置	ホアンソウチ
調和振動子	チョウワシンドウシ
片町線	カタマチセン
倒幕運動	トウバクウンドウ
静態保存	セイタイホゾン
恋愛小説	レンアイショウセツ
感情	カンジョウ
感情の一覧	カンジョウノイチラン
音楽療法	オンガクリョウホウ
船橋法典駅	フナバシホウテンエキ
大宮市	オオミヤシ
受電設備	ジュデンセツビ
突撃砲	トツゲキホウ
長門国	ナガトノクニ
鹿児島市	カゴシマシ
茅ヶ崎市	チガサキシ
五十鈴依媛命	イスズヨリヒメノミコト
帯電	タイデン
立山	タテヤマ
的場駅	マトバエキ
中川区	ナカガワク
勤労感謝の日	キンロウカンシャノヒ
紀元節	キゲンセツ
端午	タンゴ
海の日	ウミノヒ
紀元前11世紀	キゲンゼンジュウイチセイキ
風俗店	フウゾクテン
風俗嬢	フウゾクジョウ
防衛大学校	ボウエイダイガッコウ
京急東神奈川駅	ケイキュウヒガシカナガワエキ
性風俗関連特殊営業	セイフウゾクカンレントクシュエイギョウ
女神	メガミ
久留米市	クルメシ
秩父市	チチブシ
札沼線	サッショウセン
松平郷	マツダイラゴウ
共産貴族	キョウサンキゾク
音速	オンソク
黄道	コウドウ
春分点	シュンブンテン
秋分点	シュウブンテン
酒井氏	サカイシ
徳川十六神将	トクガワジュウロクシンショウ
台湾民主国	タイワンミンシュコク
豊前国	ブゼンノクニ
社会民主連合	シャカイミンシュレンゴウ
於大の方	オダイノカタ
複写機	フクシャキ
模型	モケイ
徳川四天王	トクガワシテンノウ
諫早駅	イサハヤエキ
海洋堂	カイヨウドウ
民主社会党	ミンシュシャカイトウ
納音	ナッチン
二歩	ニフ
遷都	セント
道ノ尾駅	ミチノオエキ
現川駅	ウツツガワエキ
五音音階	ゴオンオンカイ
七音音階	シチオンオンカイ
旋律型	センリツケイ
箏曲	ソウキョク
長唄	ナガウタ
義太夫節	ギダユウブシ
関白	カンパク
在日本朝鮮人総聯合会	ザイニホンチョウセンジンソウレンゴウカイ
焼夷弾	ショウイダン
下高井戸駅	シモタカイドエキ
黄道吉日	コウドウキチニチ
指示電気計器	シジデンキケイキ
相撲用語一覧	スモウヨウゴイチラン
蔵前国技館	クラマエコクギカン
決まり手	キマリテ
麻生駅	アサブエキ
応仁の乱	オウニンノラン
保守点検用電気計測器	ホシュテンケンヨウデンキケイソクキ
学部	ガクブ
巴戦	トモエセン
痛風	ツウフウ
洩	セツ
伝通院	デンヅウイン
不降	フコウ
遮断器	シャダンキ
享保	キョウホウ
空気調和設備	クウキチョウワセツビ
除湿機	ジョシツキ
家庭用電気機械器具	カテイヨウデンキキカイキグ
電気保安操作	デンキホアンソウサ
断路器	ダンロキ
接触器	セッショクキ
踏切	フミキリ
思想家一覧	シソウカイチラン
禹	ウ
鯀	コン
隅田川	スミダガワ
抗凝固薬	コウギョウコヤク
保元の乱	ホウゲンノラン
平埔族	ヘイホゾク
電線路	デンセンロ
上越線	ジョウエツセン
熱伝導率	ネツデンドウリツ
鉛筆	エンピツ
国立印刷局	コクリツインサツキョク
文房具	ブンボウグ
缶	カン
浅草駅	アサクサエキ
局地風	キョクチフウ
六甲颪	ロッコウオロシ
一級水系	イッキュウスイケイ
二級水系	ニキュウスイケイ
機械材料	キカイザイリョウ
部品	ブヒン
射水郡	イミズグン
花笠まつり	ハナガサマツリ
密度	ミツド
薩摩国	サツマノクニ
宝塚市	タカラヅカシ
中華民国の行政区分	チュウカミンコクノギョウセイクブン
多禰国	タネノクニ
主要地方道	シュヨウチホウドウ
優等列車	ユウトウレッシャ
地方交通線	チホウコウツウセン
帝釈天	タイシャクテン
悪魔	アクマ
三河島駅	ミカワシマエキ
邑楽郡	オウラグン
安全側線	アンゼンソクセン
高雄	タカオ
同人誌即売会	ドウジンシソクバイカイ
不当	フトウ
大隅国	オオスミノクニ
非人道的	ヒジンドウテキ
美少年	ビショウネン
容姿	ヨウシ
未成年者	ミセイネンシャ
対義語	タイギゴ
類義語	ルイギゴ
国際展示場駅	コクサイテンジジョウエキ
松山市	マツヤマシ
お台場海浜公園駅	オダイバカイヒンコウエンエキ
王手	オウテ
十二進法	ジュウニシンホウ
口	クチ
剛体	ゴウタイ
まわり将棋	マワリショウギ
仙台市地下鉄	センダイシチカテツ
偈	ゲ
伽陀	カダ
住職	ジュウショク
寄居駅	ヨリイエキ
釜石線	カマイシセン
天津小湊町	アマツコミナトマチ
伝聞証拠禁止の原則	デンブンショウコキンシノゲンソク
成田市	ナリタシ
白髪三千丈	ハクハツサンゼンジョウ
東京都写真美術館	トウキョウトシャシンビジュツカン
海軍記念日	カイグンキネンビ
撥弦楽器	ハツゲンガッキ
鍵盤楽器	ケンバンガッキ
打楽器	ダガッキ
一次電池	イチジデンチ
二次電池	ニジデンチ
電熱	デンネツ
水天宮前駅	スイテングウマエエキ
電気楽器	デンキガッキ
光源	コウゲン
電子楽器	デンシガッキ
電力応用	デンリョクオウヨウ
弦楽器	ゲンガッキ
工具	コウグ
対馬国	ツシマノクニ
壱岐国	イキノクニ
東京工業大学	トウキョウコウギョウダイガク
横浜美術館	ヨコハマビジュツカン
国立大学	コクリツダイガク
相模原駅	サガミハラエキ
指定区間	シテイクカン
県庁通り	ケンチョウドオリ
中核市	チュウカクシ
京阪本線	ケイハンホンセン
熊本大学	クマモトダイガク
桜島線	サクラジマセン
日光江戸村	ニッコウエドムラ
低圧放電灯	テイアツホウデントウ
縁日	エンニチ
電波新聞社	デンパシンブンシャ
京王百貨店	ケイオウヒャッカテン
交流電動機	コウリュウデンドウキ
労働基本権	ロウドウキホンケン
同期電動機	ドウキデンドウキ
交流整流子電動機	コウリュウセイリュウシデンドウキ
国民主権	コクミンシュケン
印刷会社	インサツガイシャ
肥後国	ヒゴノクニ
公傷制度	コウショウセイド
本場所	ホンバショ
電子商店街	デンシショウテンガイ
取手駅	トリデエキ
重祚	チョウソ
救世軍	キュウセイグン
譲位	ジョウイ
篠ノ井線	シノノイセン
桜井線	サクライセン
重戦車	ジュウセンシャ
東京理科大学	トウキョウリカダイガク
単相誘導電動機	タンソウユウドウデンドウキ
春分の日	シュンブンノヒ
性教育	セイキョウイク
中野区	ナカノク
三郷市	ミサトシ
昭和通り	ショウワドオリ
軽油	ケイユ
香辛料	コウシンリョウ
紅茶	コウチャ
事故	ジコ
魚醤	ギョショウ
楽器分類別一覧	ガッキブンルイベツイチラン
大砲	タイホウ
拍子	ヒョウシ
厳島	イツクシマ
松島	マツシマ
品質工学	ヒンシツコウガク
鈴鹿市	スズカシ
対戦車砲	タイセンシャホウ
かご形三相誘導電動機	カゴガタサンソウユウドウデンドウキ
巻線形三相誘導電動機	マキセンガタサンソウユウドウデンドウキ
日本の色の一覧	ニホンノイロノイチラン
鎌倉幕府の執権一覧	カマクラバクフノシッケンイチラン
優勝	ユウショウ
白虎	ビャッコ
意味	イミ
万葉線	マンヨウセン
福井市	フクイシ
三賞	サンショウ
総選挙	ソウセンキョ
水入り	ミズイリ
四大奇書	シダイキショ
行司	ギョウジ
物言い	モノイイ
取り直し	トリナオシ
特定地方交通線	トクテイチホウコウツウセン
新田郡	ニッタグン
碓氷郡	ウスイグン
海外旅行	カイガイリョコウ
群馬郡	グンマグン
北群馬郡	キタグンマグン
多野郡	タノグン
甘楽郡	カンラグン
吾妻郡	アガツマグン
利根郡	トネグン
筑前国	チクゼンノクニ
お化け屋敷	オバケヤシキ
八朔	ハッサク
聖女	セイジョ
前頭	マエガシラ
手話	シュワ
妹	イモウト
宣伝	センデン
輪姦	リンカン
情報収集衛星	ジョウホウシュウシュウエイセイ
筑後国	チクゴノクニ
彩の森入間公園	サイノモリイルマコウエン
南橋本駅	ミナミハシモトエキ
上溝駅	カミミゾエキ
喜界空港	キカイクウコウ
山県郡	ヤマガタグン
未来派	ミライハ
山県市	ヤマガタシ
関西本線	カンサイホンセン
設備	セツビ
偶然	グウゼン
公式	コウシキ
鎌倉高校前駅	カマクラコウコウマエエキ
腰越駅	コシゴエエキ
多砲塔戦車	タホウトウセンシャ
食器	ショッキ
富嶽	フガク
択捉島	エトロフトウ
浅草公園六区	アサクサコウエンロック
南千住駅	ミナミセンジュエキ
新御徒町駅	シンオカチマチエキ
高所恐怖症	コウショキョウフショウ
紀州鉄道線	キシュウテツドウセン
縦組み	タテグミ
快速急行	カイソクキュウコウ
雲	クモ
小山市	オヤマシ
写研	シャケン
長野環状道路	ナガノカンジョウドウロ
肝癌	カンガン
五線譜	ゴセンフ
回収戦車	カイシュウセンシャ
若柳町	ワカヤナギチョウ
架橋戦車	カキョウセンシャ
津波	ツナミ
降水確率	コウスイカクリツ
西夏文字	セイカモジ
核砲弾	カクホウダン
中小国駅	ナカオグニエキ
対局時計	タイキョクドケイ
草津線	クサツセン
湖西線	コセイセン
四日市駅	ヨッカイチエキ
京急川崎駅	ケイキュウカワサキエキ
京急蒲田駅	ケイキュウカマタエキ
矢向駅	ヤコウエキ
箱館裁判所	ハコダテサイバンショ
緑茶	リョクチャ
低気圧	テイキアツ
高気圧	コウキアツ
国立公園	コクリツコウエン
関西空港線	カンサイクウコウセン
低周波	テイシュウハ
角運動量	カクウンドウリョウ
福知山線	フクチヤマセン
角運動量保存の法則	カクウンドウリョウホゾンノホウソク
国定公園	コクテイコウエン
戦後民主主義	センゴミンシュシュギ
和泉監	イズミノゲン
擬似乱数	ギジランスウ
数字	スウジ
電磁石同期電動機	デンジシャクドウキデンドウキ
電圧源	デンアツゲン
電流源	デンリュウゲン
門松	カドマツ
渡り鳥	ワタリドリ
正月	ショウガツ
法典化	ホウテンカ
数え年	カゾエドシ
90式戦車	キュウマルシキセンシャ
初夢	ハツユメ
日中国交正常化	ニッチュウコッコウセイジョウカ
粒子線	リュウシセン
阪神なんば線	ハンシンナンバセン
箱館府	ハコダテフ
目黒区	メグロク
熱田神宮	アツタジングウ
炊飯器	スイハンキ
廃線	ハイセン
連合王国	レンゴウオウコク
界磁	カイジ
電機子	デンキシ
版下	ハンシタ
日ノ出町駅	ヒノデチョウエキ
鳥取地震	トットリジシン
文京区	ブンキョウク
尋	ヒロ
電子相関	デンシソウカン
仙台駅	センダイエキ
東北大学の学生寄宿舎	トウホクダイガクノガクセイキシュクシャ
民主党	ミンシュトウ
防府市	ホウフシ
同期発電機	ドウキハツデンキ
誘導発電機	ユウドウハツデンキ
かご形三相誘導発電機	カゴガタサンソウユウドウハツデンキ
巻線形三相誘導発電機	マキセンガタサンソウユウドウハツデンキ
宇部市	ウベシ
岩沼駅	イワヌマエキ
西宮市	ニシノミヤシ
渡島国	オシマノクニ
後志国	シリベシノクニ
凱旋門賞	ガイセンモンショウ
落語家	ラクゴカ
鈴鹿山脈	スズカサンミャク
山陰本線	サンインホンセン
永久磁石同期発電機	エイキュウジシャクドウキハツデンキ
電磁石同期発電機	デンジシャクドウキハツデンキ
名人戦	メイジンセン
小田急箱根	オダキュウハコネ
九七式自動砲	キュウナナシキジドウホウ
巻線	マキセン
応永の外寇	オウエイノガイコウ
上方噺家	カミガタハナシカ
最高裁判所長官	サイコウサイバンショチョウカン
胆振国	イブリノクニ
荒川区	アラカワク
名鉄名古屋駅	メイテツナゴヤエキ
赤字83線	アカジハチジュウサンセン
放流	ホウリュウ
北斗神拳	ホクトシンケン
嵯峨野線	サガノセン
網走市	アバシリシ
十勝国	トカチノクニ
新進党	シンシントウ
指し棒	サシボウ
特別急行券	トクベツキュウコウケン
整流子機の電機子反作用	セイリュウシキノデンキシハンサヨウ
東武動物公園駅	トウブドウブツコウエンエキ
日本海呼称問題	ニホンカイコショウモンダイ
碓氷峠	ウスイトウゲ
酸素魚雷	サンソギョライ
市	シ
系統連系	ケイトウレンケイ
内閣改造	ナイカクカイゾウ
若葉台駅	ワカバダイエキ
千島国	チシマノクニ
南北戦争	ナンボクセンソウ
地雷原	ジライゲン
無限軌道	ムゲンキドウ
爆撃機	バクゲキキ
歩兵戦闘車	ホヘイセントウシャ
三角数	サンカクスウ
人面魚	ジンメンギョ
気団	キダン
羽前国	ウゼンノクニ
陸中国	リクチュウノクニ
陸前国	リクゼンノクニ
民法学	ミンポウガク
上板橋駅	カミイタバシエキ
志木市	シキシ
戸田市	トダシ
雪	ユキ
三味線	シャミセン
特攻兵器	トッコウヘイキ
気候	キコウ
温帯	オンタイ
時刻表	ジコクヒョウ
鶴見線	ツルミセン
海芝浦駅	ウミシバウラエキ
決まり字	キマリジ
山上たつひこ	ヤマガミタツヒコ
みどりの駅	ミドリノエキ
新桜台駅	シンサクラダイエキ
直流発電機	チョクリュウハツデンキ
磐城国	イワキノクニ
岩代国	イワシロノクニ
芳野監	ヨシノノゲン
横須賀駅	ヨコスカエキ
小樽市	オタルシ
南大沢駅	ミナミオオサワエキ
成人式	セイジンシキ
近鉄四日市駅	キンテツヨッカイチエキ
朝霞市	アサカシ
東京高速道路	トウキョウコウソクドウロ
京都河原町駅	キョウトカワラマチエキ
紀元前100年	キゲンゼンヒャクネン
膵臓	スイゾウ
相州	ソウシュウ
総州	ソウシュウ
丹州	タンシュウ
五情	ゴジョウ
怪談	カイダン
博物館	ハクブツカン
小竹向原駅	コタケムカイハラエキ
砂漠化	サバクカ
砂漠緑化	サバクリョクカ
参宮線	サングウセン
岩泉線	イワイズミセン
世界三大一覧	セカイサンダイイチラン
極性分子	キョクセイブンシ
開拓使	カイタクシ
日本三大一覧	ニホンサンダイイチラン
運動量保存則	ウンドウリョウホゾンソク
大鳥居駅	オオトリイエキ
飛騨	ヒダ
伊賀	イガ
伊勢	イセ
遠江	トオトウミ
出雲	イズモ
石見	イワミ
上石神井駅	カミシャクジイエキ
新潟市	ニイガタシ
樺太開拓使	カラフトカイタクシ
横断歩道橋	オウダンホドウキョウ
御璽	ギョジ
波力発電	ハリョクハツデン
第一東海自動車道	ダイイチトウカイジドウシャドウ
中国縦貫自動車道	チュウゴクジュウカンジドウシャドウ
無整流子電動機	ムセイリュウシデンドウキ
市町村道	シチョウソンドウ
都道府県道	トドウフケンドウ
東京府	トウキョウフ
鎖国	サコク
神戸市交通局	コウベシコウツウキョク
神戸市営地下鉄	コウベシエイチカテツ
国民栄誉賞	コクミンエイヨショウ
都市写真	トシシャシン
栃木市	トチギシ
令制国	リョウセイコク
雷電	ライデン
国民楽派	コクミンガクハ
江戸噺家	エドハナシカ
飯田線	イイダセン
飯田市	イイダシ
宮内庁	クナイチョウ
西九条駅	ニシクジョウエキ
建国記念日	ケンコクキネンビ
冒険小説	ボウケンショウセツ
新鎌ヶ谷駅	シンカマガヤエキ
八戸駅	ハチノヘエキ
傀儡政権	カイライセイケン
包絡線	ホウラクセン
和光市	ワコウシ
蝦夷共和国	エゾキョウワコク
竹林の七賢	チクリンノシチケン
代替医療	ダイタイイリョウ
折り畳み自転車	オリタタミジテンシャ
六甲山	ロッコウサン
北魚沼郡	キタウオヌマグン
反比例	ハンピレイ
鉄道敷設法	テツドウフセツホウ
東洋医学	トウヨウイガク
東京国立博物館	トウキョウコクリツハクブツカン
閉集合	ヘイシュウゴウ
左京区	サキョウク
姉妹	シマイ
比例代表制	ヒレイダイヒョウセイ
移調	イチョウ
異名同音	イメイドウオン
新特急	シントッキュウ
円錐曲線	エンスイキョクセン
庚申塔	コウシントウ
紀元前490年	キゲンゼンヨンヒャクキュウジュウネン
発電用水車	ハツデンヨウスイシャ
真空準位	シンクウジュンイ
壬申戸籍	ジンシンコセキ
円錐	エンスイ
汐留駅	シオドメエキ
随筆	ズイヒツ
竹芝駅	タケシバエキ
日の出駅	ヒノデエキ
過激派	カゲキハ
宝塚歌劇団	タカラヅカカゲキダン
鞍馬寺	クラマデラ
催奇性	サイキセイ
三宮	サンノミヤ
宝塚駅	タカラヅカエキ
大井競馬場前駅	オオイケイバジョウマエエキ
甲州征伐	コウシュウセイバツ
国籍	コクセキ
代替医療一覧	ダイタイイリヨウイチラン
七草	ナナクサ
七五三	シチゴサン
飯塚市	イイヅカシ
一党制	イットウセイ
併合罪	ヘイゴウザイ
港北区	コウホクク
孤立主義	コリツシュギ
漢民族	カンミンゾク
責任	セキニン
十二神将	ジュウニシンショウ
紀元前544年	キゲンゼンゴヒャクヨンジュウヨンネン
柱体	チュウタイ
新日本橋駅	シンニホンバシエキ
奥羽越列藩同盟	オウウエツレッパンドウメイ
戦役	センエキ
東十条駅	ヒガシジュウジョウエキ
和田岬線	ワダミサキセン
加古川線	カコガワセン
通信工学	ツウシンコウガク
無線工学	ムセンコウガク
変調方式	ヘンチョウホウシキ
身分制度	ミブンセイド
小型自動二輪車	コガタジドウニリンシャ
普通自動二輪車	フツウジドウニリンシャ
奈良先端科学技術大学院大学	ナラセンタンカガクギジュツダイガクインダイガク
憲法改正	ケンポウカイセイ
岩本町駅	イワモトチョウエキ
万世橋駅	マンセイバシエキ
馬喰町駅	バクロチョウエキ
三越前駅	ミツコシマエエキ
投票	トウヒョウ
議員定数	ギインテイスウ
札幌村	サッポロムラ
空軍	クウグン
軽空母	ケイクウボ
漢字直接入力	カンジチョクセツニュウリョク
家庭裁判所	カテイサイバンショ
累犯	ルイハン
発明	ハツメイ
宮の坂駅	ミヤノサカエキ
急降下爆撃機	キュウコウカバクゲキキ
攻撃機	コウゲキキ
急降下爆撃	キュウコウカバクゲキ
八音	ハチオン
巡洋艦	ジュンヨウカン
電子管	デンシカン
三国干渉	サンゴクカンショウ
二次方程式	ニジホウテイシキ
飛行艇	ヒコウテイ
配線部品	ハイセンブヒン
論理回路	ロンリカイロ
超漢字	チョウカンジ
可部線	カベセン
時代小説	ジダイショウセツ
歴史小説	レキシショウセツ
林道	リンドウ
明石市	アカシシ
転調	テンチョウ
農道	ノウドウ
支援戦闘機	シエンセントウキ
陸上自衛隊	リクジョウジエイタイ
航空自衛隊	コウクウジエイタイ
地震学	ジシンガク
和算	ワサン
輸送機	ユソウキ
舞鶴線	マイヅルセン
小浜線	オバマセン
境線	サカイセン
平方完成	ヘイホウカンセイ
74式戦車	ナナヨンシキセンシャ
自衛戦争	ジエイセンソウ
自衛権	ジエイケン
練馬高野台駅	ネリマタカノダイエキ
関門橋	カンモンキョウ
戦争一覧	センソウイチラン
赤穂線	アコウセン
ワルング語	ワルングゴ
播但線	バンタンセン
姫新線	キシンセン
戦闘爆撃機	セントウバクゲキキ
耐力	タイリョク
松前藩	マツマエハン
いろは順	イロハジュン
津山駅	ツヤマエキ
美作落合駅	ミマサカオチアイエキ
刑部駅	オサカベエキ
美作追分駅	ミマサカオイワケエキ
丹治部駅	タジベエキ
おひつじ座	オヒツジザ
福山藩	フクヤマハン
ふたご座	フタゴザ
かに座	カニザ
てんびん座	テンビンザ
さそり座	サソリザ
いて座	イテザ
みずがめ座	ミズガメザ
芋煮会	イモニカイ
戦略爆撃	センリャクバクゲキ
床	ユカ
白	シロ
越美北線	エツミホクセン
高山本線	タカヤマホンセン
火の鳥	ヒノトリ
瓦	カワラ
弾性	ダンセイ
朝鮮の仏教	チョウセンノブッキョウ
軟体動物	ナンタイドウブツ
津山線	ツヤマセン
電位	デンイ
吉備線	キビセン
福塩線	フクエンセン
模型雑誌	モケイザッシ
因美線	インビセン
米子駅	ヨナゴエキ
八専	ハッセン
七曜	シチヨウ
蝦夷地	エゾチ
函館市	ハコダテシ
伯備線	ハクビセン
芸備線	ゲイビセン
天領	テンリョウ
和人地	ワジンチ
福北ゆたか線	フクホクユタカセン
水球	スイキュウ
盛岡藩	モリオカハン
みどりの窓口	ミドリノマドグチ
宇野線	ウノセン
本四備讃線	ホンシビサンセン
瀬戸大橋線	セトオオハシセン
電波型式の表記法	デンパカタシキノヒョウキホウ
西武秩父駅	セイブチチブエキ
岩徳線	ガントクセン
関東三大七夕祭り	カントウサンダイタナバタマツリ
皇居	コウキョ
拒否権	キョヒケン
新党さきがけ	シントウサキガケ
共同正犯	キョウドウセイハン
罪	ツミ
三隣亡	サンリンボウ
伝送工学	デンソウコウガク
伝送路	デンソウロ
確認申請	カクニンシンセイ
電卓	デンタク
公園	コウエン
八戸藩	ハチノヘハン
七戸藩	シチノヘハン
貨幣	カヘイ
箕面駅	ミノオエキ
牧落駅	マキオチエキ
石橋阪大前駅	イシバシハンダイマエエキ
一世一元の制	イッセイイチゲンノセイ
名古屋港	ナゴヤコウ
戸塚区	トツカク
都市計画	トシケイカク
七尾線	ナナオセン
法家	ホウカ
表高	オモテダカ
内高	ウチダカ
大為爾の歌	タヰニノウタ
絶対君主制	ゼッタイクンシュセイ
絶対王政	ゼッタイオウセイ
諸侯	ショコウ
閏秒	ウルウビョウ
法界院駅	ホウカイインエキ
福山駅	フクヤマエキ
東福山駅	ヒガシフクヤマエキ
上郡駅	カミゴオリエキ
佐用駅	サヨエキ
智頭駅	チズエキ
郡家駅	コオゲエキ
鳥取駅	トットリエキ
境港駅	サカイミナトエキ
鳥取大学前駅	トットリダイガクマエエキ
岡山駅	オカヤマエキ
屯田兵	トンデンヘイ
茶屋町駅	チャヤマチエキ
倉敷駅	クラシキエキ
総社駅	ソウジャエキ
東総社駅	ヒガシソウジャエキ
福渡駅	フクワタリエキ
備前原駅	ビゼンハラエキ
玉柏駅	タマガシエキ
牧山駅	マキヤマエキ
備前西市駅	ビゼンニシイチエキ
妹尾駅	セノオエキ
児島駅	コジマエキ
西春日井郡	ニシカスガイグン
利益	リエキ
弓削駅	ユゲエキ
美作滝尾駅	ミマサカタキオエキ
三浦駅	ミウラエキ
土師駅	ハジエキ
那岐駅	ナギエキ
恋山形駅	コイヤマガタエキ
山郷駅	ヤマサトエキ
東郡家駅	ヒガシコオゲエキ
津ノ井駅	ツノイエキ
国英駅	クニフサエキ
八頭高校前駅	ヤズコウコウマエエキ
因幡船岡駅	イナバフナオカエキ
隼駅	ハヤブサエキ
安部駅	アベエキ
八東駅	ハットウエキ
徳丸駅	トクマルエキ
丹比駅	タンピエキ
若桜駅	ワカサエキ
用瀬駅	モチガセエキ
因幡社駅	イナバヤシロエキ
鷹狩駅	タカガリエキ
河原駅	カワハラエキ
末恒駅	スエツネエキ
湖山駅	コヤマエキ
宝木駅	ホウギエキ
浜村駅	ハマムラエキ
青谷駅	アオヤエキ
福部駅	フクベエキ
大岩駅	オオイワエキ
岩美駅	イワミエキ
東浜駅	ヒガシハマエキ
出雲市駅	イズモシエキ
益田駅	マスダエキ
備前三門駅	ビゼンミカドエキ
備前一宮駅	ビゼンイチノミヤエキ
吉備津駅	キビツエキ
備中高松駅	ビッチュウタカマツエキ
足守駅	アシモリエキ
西大寺駅	サイダイジエキ
大多羅駅	オオダラエキ
備後本庄駅	ビンゴホンジョウエキ
横尾駅	ヨコオエキ
万能倉駅	マナグラエキ
駅家駅	エキヤエキ
新市駅	シンイチエキ
近田駅	チカタエキ
戸手駅	トデエキ
上戸手駅	カミトデエキ
備後赤坂駅	ビンゴアカサカエキ
西阿知駅	ニシアチエキ
吉永駅	ヨシナガエキ
東岡山駅	ヒガシオカヤマエキ
高島駅	タカシマエキ
大富駅	オオドミエキ
邑久駅	オクエキ
長船駅	オサフネエキ
香登駅	カガトエキ
伊部駅	インベエキ
西片上駅	ニシカタカミエキ
備前片上駅	ビゼンカタカミエキ
伊里駅	イリエキ
日生駅	ヒナセエキ
寒河駅	ソウゴエキ
天和駅	テンワエキ
播州赤穂駅	バンシュウアコウエキ
坂越駅	サコシエキ
西相生駅	ニシアイオイエキ
竜野駅	タツノエキ
八橋駅	ヤバセエキ
豪渓駅	ゴウケイエキ
近鉄富田駅	キンテツトミダエキ
恩智駅	オンヂエキ
高安駅	タカヤスエキ
五位堂駅	ゴイドウエキ
弓ケ浜駅	ユミガハマエキ
後藤駅	ゴトウエキ
博労町駅	バクロウマチエキ
三本松口駅	サンボンマツグチエキ
河崎口駅	カワサキグチエキ
和田浜駅	ワダハマエキ
高松町駅	タカマツチョウエキ
余子駅	アマリコエキ
馬場崎町駅	ババサキチョウエキ
西出雲駅	ニシイズモエキ
労働者	ロウドウシャ
北斗星	ホクトセイ
曜日	ヨウビ
三鷹市	ミタカシ
泉鏡花文学賞	イズミキョウカブンガクショウ
文学賞	ブンガクショウ
調布駅	チョウフエキ
卒業	ソツギョウ
保守党	ホシュトウ
七大陸最高峰	ナナタイリクサイコウホウ
清音駅	キヨネエキ
備中箕島駅	ビッチュウミシマエキ
彦崎駅	ヒコサキエキ
備前片岡駅	ビゼンカタオカエキ
迫川駅	ハザカワエキ
常山駅	ツネヤマエキ
八浜駅	ハチハマエキ
備前田井駅	ビゼンタイエキ
宇野駅	ウノエキ
植松駅	ウエマツエキ
大元駅	オオモトエキ
早島駅	ハヤシマエキ
久々原駅	クグハラエキ
建部駅	タケベエキ
金川駅	カナガワエキ
野々口駅	ノノクチエキ
神目駅	コウメエキ
誕生寺駅	タンジョウジエキ
亀甲駅	カメノコウエキ
佐良山駅	サラヤマエキ
宮本武蔵駅	ミヤモトムサシエキ
西粟倉駅	ニシアワクラエキ
あわくら温泉駅	アワクラオンセンエキ
可部駅	カベエキ
上八木駅	カミヤギエキ
七軒茶屋駅	シチケンヂャヤエキ
緑井駅	ミドリイエキ
三滝駅	ミタキエキ
防府駅	ホウフエキ
徳山駅	トクヤマエキ
広島駅	ヒロシマエキ
新倉敷駅	シンクラシキエキ
三原駅	ミハラエキ
都市	トシ
中神	ナカガミ
鍋	ナベ
予讃線	ヨサンセン
内子線	ウチコセン
交換工学	コウカンコウガク
高松駅	タカマツエキ
文章題	ブンショウダイ
鶴亀算	ツルカメザン
新下関駅	シンシモノセキエキ
過不足算	カフソクザン
糸崎駅	イトザキエキ
瀬戸駅	セトエキ
平福駅	ヒラフクエキ
植木算	ウエキザン
久崎駅	クザキエキ
河野原円心駅	コウノハラエンシンエキ
苔縄駅	コケナワエキ
仕事算	シゴトザン
吉備真備駅	キビノマキビエキ
道上駅	ミチノウエエキ
湯田村駅	ユダムラエキ
神辺駅	カンナベエキ
小町算	コマチザン
着色料	チャクショクリョウ
三次駅	ミヨシエキ
塩町駅	シオマチエキ
鋳造	チュウゾウ
日羽駅	ヒワエキ
美袋駅	ミナギエキ
備中広瀬駅	ビッチュウヒロセエキ
伯耆大山駅	ホウキダイセンエキ
岸本駅	キシモトエキ
伯耆溝口駅	ホウキミゾグチエキ
江尾駅	エビエキ
年齢算	ネンレイザン
武庫駅	ムコエキ
根雨駅	ネウエキ
黒坂駅	クロサカエキ
上菅駅	カミスゲエキ
平行四辺形	ヘイコウシヘンケイ
生山駅	ショウヤマエキ
上石見駅	カミイワミエキ
下北条駅	シモホウジョウエキ
由良駅	ユラエキ
赤碕駅	アカサキエキ
中山口駅	ナカヤマグチエキ
下市駅	シモイチエキ
御来屋駅	ミクリヤエキ
大山口駅	ダイセングチエキ
淀江駅	ヨドエエキ
揖屋駅	イヤエキ
荒島駅	アラシマエキ
安来駅	ヤスギエキ
乃木駅	ノギエキ
玉造温泉駅	タマツクリオンセンエキ
来待駅	キマチエキ
宍道駅	シンジエキ
荘原駅	ショウバラエキ
直江駅	ナオエエキ
皮膚炎	ヒフエン
九九	クク
木次線	キスキセン
備後庄原駅	ビンゴショウバラエキ
院庄駅	インノショウエキ
安芸長束駅	アキナガツカエキ
下祇園駅	シモギオンエキ
古市橋駅	フルイチバシエキ
笠岡駅	カサオカエキ
里庄駅	サトショウエキ
尾道駅	オノミチエキ
本竜野駅	ホンタツノエキ
三江線	サンコウセン
山口線	ヤマグチセン
江津駅	ゴウツエキ
浜田駅	ハマダエキ
大田市駅	オオダシエキ
味噌	ミソ
麺	メン
硬貨	コウカ
生駒市	イコマシ
御宿町	オンジュクマチ
気象庁地磁気観測所	キショウチョウチジキカンソクショ
守谷駅	モリヤエキ
総合通信基盤局	ソウゴウツウシンキバンキョク
公共体	コウキョウタイ
重力相互作用	ジュウリョクソウゴサヨウ
若江岩田駅	ワカエイワタエキ
初芝駅	ハツシバエキ
萩原天神駅	ハギハラテンジンエキ
堺	サカイ
蘇我駅	ソガエキ
献血	ケンケツ
尾関山駅	オゼキヤマエキ
美作加茂駅	ミマサカカモエキ
知和駅	チワエキ
美作河井駅	ミマサカカワイエキ
備後西城駅	ビンゴサイジョウエキ
波子駅	ハシエキ
温泉津駅	ユノツエキ
仁万駅	ニマエキ
三保三隅駅	ミホミスミエキ
長門三隅駅	ナガトミスミエキ
長門市駅	ナガトシエキ
東萩駅	ヒガシハギエキ
萩駅	ハギエキ
厚狭駅	アサエキ
新岩国駅	シンイワクニエキ
清流新岩国駅	セイリュウシンイワクニエキ
万富駅	マントミエキ
熊山駅	クマヤマエキ
和気駅	ワケエキ
大阪府咲洲庁舎	オオサカフサキシマチョウシャ
国際空港の一覧	コクサイクウコウノイチラン
宇部線	ウベセン
小野田線	オノダセン
交響詩	コウキョウシ
重要影響事態	ジュウヨウエイキョウジタイ
皿	サラ
箸	ハシ
口羽駅	クチバエキ
伊賀和志駅	イカワシエキ
鍼灸大学前駅	シンキュウダイガクマエエキ
福島放送	フクシマホウソウ
太多線	タイタセン
大糸線	オオイトセン
走り屋	ハシリヤ
実験	ジッケン
靖国神社問題	ヤスクニジンジャモンダイ
家具	カグ
飲料	インリョウ
魚群探知機	ギョグンタンチキ
自動販売機	ジドウハンバイキ
記紀	キキ
破産	ハサン
鳳凰	ホウオウ
啓	ケイ
香淀駅	コウヨドエキ
作木口駅	サクギグチエキ
江平駅	ゴウビラエキ
三皇五帝	サンコウゴテイ
鹿児島本線	カゴシマホンセン
菓子	カシ
飴	アメ
客家語	ハッカゴ
家屋	カオク
暦注下段	レキチュウゲダン
建築家	ケンチクカ
生体高分子	セイタイコウブンシ
工業化学	コウギョウカガク
興行収入	コウギョウシュウニュウ
性同一性	セイドウイツセイ
湯沢町	ユザワマチ
平均場近似	ヘイキンバキンジ
土讃線	ドサンセン
読書週間	ドクショシュウカン
加賀藩	カガハン
国旗	コッキ
比叡山鉄道線	ヒエイザンテツドウセン
愛知環状鉄道線	アイチカンジョウテツドウセン
宇部駅	ウベエキ
小野田駅	オノダエキ
居能駅	イノウエキ
岩鼻駅	イワハナエキ
宇部新川駅	ウベシンカワエキ
草江駅	クサエエキ
雀田駅	スズメダエキ
小野田港駅	オノダコウエキ
怪優	カイユウ
越中大門駅	エッチュウダイモンエキ
町田市	マチダシ
宿泊施設	シュクハクシセツ
合成樹脂	ゴウセイジュシ
伏見城	フシミジョウ
中康	チュウコウ
浜河内駅	ハマゴウチエキ
南小野田駅	ミナミオノダエキ
南中川駅	ミナミナカガワエキ
目出駅	メデエキ
長門長沢駅	ナガトナガサワエキ
妻崎駅	ツマザキエキ
宇部岬駅	ウベミサキエキ
琴芝駅	コトシバエキ
床波駅	トコナミエキ
丸尾駅	マルオエキ
岐波駅	キワエキ
阿知須駅	アジスエキ
周防佐山駅	スオウサヤマエキ
深溝駅	フカミゾエキ
上嘉川駅	カミカガワエキ
嘉川駅	カガワエキ
本由良駅	ホンユラエキ
厚東駅	コトウエキ
四辻駅	ヨツツジエキ
大道駅	ダイドウエキ
富海駅	トノミエキ
津和野駅	ツワノエキ
八本松駅	ハチホンマツエキ
西高屋駅	ニシタカヤエキ
白市駅	シライチエキ
河内駅	コウチエキ
中選挙区制	チュウセンキョクセイ
福川駅	フクガワエキ
新南陽駅	シンナンヨウエキ
櫛ケ浜駅	クシガハマエキ
周防花岡駅	スオウハナオカエキ
生野屋駅	イクノヤエキ
周防久保駅	スオウクボエキ
大河内駅	オオカワチエキ
勝間駅	カツマエキ
高水駅	タカミズエキ
光駅	ヒカリエキ
岩田駅	イワタエキ
田布施駅	タブセエキ
埴生駅	ハブエキ
小月駅	オヅキエキ
長府駅	チョウフエキ
岩国駅	イワクニエキ
西岩国駅	ニシイワクニエキ
南岩国駅	ミナミイワクニエキ
藤生駅	フジュウエキ
通津駅	ツヅエキ
玖波駅	クバエキ
乳製品	ニュウセイヒン
木野山駅	キノヤマエキ
備中川面駅	ビッチュウカワモエキ
名古屋城	ナゴヤジョウ
小郡駅	オゴオリエキ
方谷駅	ホウコクエキ
井倉駅	イクラエキ
石蟹駅	イシガエキ
新見駅	ニイミエキ
布原駅	ヌノハラエキ
備中神代駅	ビッチュウコウジロエキ
足立駅	アシダチエキ
岡崎市	オカザキシ
柱野駅	ハシラノエキ
欽明路駅	キンメイジエキ
玖珂駅	クガエキ
周防高森駅	スオウタカモリエキ
米川駅	ヨネカワエキ
岩山駅	イワヤマエキ
日豊本線	ニッポウホンセン
美作千代駅	ミマサカセンダイエキ
坪井駅	ツボイエキ
久世駅	クセエキ
中国勝山駅	チュウゴクカツヤマエキ
月田駅	ツキダエキ
富原駅	トミハラエキ
美作大崎駅	ミマサカオオサキエキ
西勝間田駅	ニシカツマダエキ
勝間田駅	カツマダエキ
林野駅	ハヤシノエキ
楢原駅	ナラハラエキ
美作江見駅	ミマサカエミエキ
美作土居駅	ミマサカドイエキ
上月駅	コウヅキエキ
播磨徳久駅	ハリマトクサエキ
身延線	ミノブセン
重水	ジュウスイ
名駅	メイエキ
終戦の日	シュウセンノヒ
高徳線	コウトクセン
珠算	シュザン
鳴門線	ナルトセン
屯田兵例則	トンデンヘイレイソク
神経伝達物質	シンケイデンタツブッシツ
熱化学	ネツカガク
紀元前539年	キゲンゼンゴヒャクサンジュウキュウネン
生物兵器	セイブツヘイキ
東觜崎駅	ヒガシハシサキエキ
播磨新宮駅	ハリマシングウエキ
千本駅	センボンエキ
西栗栖駅	ニシクリスエキ
八丁畷駅	ハッチョウナワテエキ
上大岡駅	カミオオオカエキ
姫路駅	ヒメジエキ
阿武隈急行線	アブクマキュウコウセン
正午	ショウゴ
矛盾	ムジュン
武豊線	タケトヨセン
滝川市	タキカワシ
投手	トウシュ
揚水発電	ヨウスイハツデン
高層天気図	コウソウテンキズ
魚介類	ギョカイルイ
設備投資	セツビトウシ
胡麻駅	ゴマエキ
法善寺駅	ホウゼンジエキ
堅下駅	カタシモエキ
安堂駅	アンドウエキ
水蒸気爆発	スイジョウキバクハツ
国吉駅	クニヨシエキ
肥薩線	ヒサツセン
吉都線	キットセン
えびの高原線	エビノコウゲンセン
ちゃんこ鍋	チャンコナベ
牟岐線	ムギセン
八高線	ハチコウセン
五日市線	イツカイチセン
堆積学	タイセキガク
稚内市	ワッカナイシ
山菜	サンサイ
茶色	チャイロ
母音調和	ボインチョウワ
予土線	ヨドセン
加工乳	カコウニュウ
脱脂粉乳	ダッシフンニュウ
携帯機器	ケイタイキキ
大分駅	オオイタエキ
大在駅	オオザイエキ
鶴崎駅	ツルサキエキ
台湾省	タイワンショウ
扃	ケイ
廑	キン
学習漫画	ガクシュウマンガ
かしわ台駅	カシワダイエキ
桀	ケツ
高城駅	タカジョウエキ
計算	ケイサン
海底火山	カイテイカザン
西礪波郡	ニシトナミグン
畳	タタミ
佐波郡	サワグン
幡生駅	ハタブエキ
帝国	テイコク
京王稲田堤駅	ケイオウイナダヅツミエキ
洋菓子	ヨウガシ
祐天寺駅	ユウテンジエキ
佐世保線	サセボセン
大村線	オオムラセン
指宿枕崎線	イブスキマクラザキセン
直流送電	チョクリュウソウデン
捷運	ショウウン
湯田温泉駅	ユダオンセンエキ
矢原駅	ヤバラエキ
大歳駅	オオトシエキ
仁保津駅	ニホヅエキ
上郷駅	カミゴウエキ
周防下郷駅	スオウシモゴウエキ
仁保駅	ニホエキ
上山口駅	カミヤマグチエキ
宮野駅	ミヤノエキ
篠目駅	シノメエキ
渡川駅	ワタリガワエキ
名草駅	ナグサエキ
地福駅	ジフクエキ
鍋倉駅	ナベクラエキ
徳佐駅	トクサエキ
船平山駅	フナヒラヤマエキ
青野山駅	アオノヤマエキ
日原駅	ニチハラエキ
青原駅	アオハラエキ
東青原駅	ヒガシアオハラエキ
石見横田駅	イワミヨコタエキ
本俣賀駅	ホンマタガエキ
径	ケイ
出雲神西駅	イズモジンザイエキ
南宍道駅	ミナミシンジエキ
加茂中駅	カモナカエキ
幡屋駅	ハタヤエキ
出雲大東駅	イズモダイトウエキ
南大東駅	ミナミダイトウエキ
木次駅	キスキエキ
日登駅	ヒノボリエキ
下久野駅	シモクノエキ
出雲八代駅	イズモヤシロエキ
出雲三成駅	イズモミナリエキ
亀嵩駅	カメダケエキ
紀元前12世紀	キゲンゼンジュウニセイキ
出雲横田駅	イズモヨコタエキ
八川駅	ヤカワエキ
出雲坂根駅	イズモサカネエキ
三井野原駅	ミイノハラエキ
油木駅	ユキエキ
矢賀駅	ヤガエキ
戸坂駅	ヘサカエキ
安芸矢口駅	アキヤグチエキ
玖村駅	クムラエキ
下深川駅	シモフカワエキ
中深川駅	ナカフカワエキ
上深川駅	カミフカワエキ
狩留家駅	カルガエキ
志和口駅	シワグチエキ
吉田口駅	ヨシダグチエキ
京口駅	キョウグチエキ
野里駅	ノザトエキ
砥堀駅	トホリエキ
仁豊野駅	ニブノエキ
香呂駅	コウロエキ
溝口駅	ミゾグチエキ
甘地駅	アマジエキ
鶴居駅	ツルイエキ
寺前駅	テラマエエキ
青倉駅	アオクラエキ
和田山駅	ワダヤマエキ
木見駅	キミエキ
上の町駅	カミノチョウエキ
八十場駅	ヤソバエキ
鴨川駅	カモガワエキ
日本の企業一覧	ニホンノキギョウイチラン
端岡駅	ハシオカエキ
香西駅	コウザイエキ
屋島駅	ヤシマエキ
多度津駅	タドツエキ
電信電話記念日	デンシンデンワキネンビ
由宇駅	ユウエキ
大畠駅	オオバタケエキ
柳井港駅	ヤナイミナトエキ
柳井駅	ヤナイエキ
親族	シンゾク
冠位十二階	カンイジュウニカイ
水銀整流器	スイギンセイリュウキ
国立故宮博物院	コクリツコキュウハクブツイン
量子条件	リョウシジョウケン
柳川市	ヤナガワシ
報道写真	ホウドウシャシン
三角線	ミスミセン
極値	キョクチ
湘南深沢駅	ショウナンフカサワエキ
追分	オイワケ
馬子唄	マゴウタ
血液型	ケツエキガタ
越中おわら節	エッチュウオワラブシ
悪意	アクイ
管轄	カンカツ
黒田節	クロダブシ
松山中央公園野球場	マツヤマチュウオウコウエンヤキュウジョウ
蒸留酒	ジョウリュウシュ
湘南町屋駅	ショウナンマチヤエキ
共謀共同正犯	キョウボウキョウドウセイハン
身体刑	シンタイケイ
令状	レイジョウ
善意取得	ゼンイシュトク
即時取得	ソクジシュトク
西鎌倉駅	ニシカマクラエキ
松山城	マツヤマジョウ
湘南江の島駅	ショウナンエノシマエキ
知る権利	シルケンリ
法例	ホウレイ
間接正犯	カンセツセイハン
帰化	キカ
投資信託	トウシシンタク
預金	ヨキン
準正	ジュンセイ
美唄市	ビバイシ
美祢線	ミネセン
創造論	ソウゾウロン
三好三人衆	ミヨシサンニンシュウ
五大老	ゴタイロウ
豊肥本線	ホウヒホンセン
摂政	セッショウ
石田彰・岸祐二の五番街で逢いましょう	イシダアキラキシユウジノゴバンガイデアイマショウ
魔術	マジュツ
暴走族	ボウソウゾク
足場	アシバ
鹿島線	カシマセン
三環系抗うつ薬	サンカンケイコウウツヤク
著作家	チョサクカ
久大本線	キュウダイホンセン
唐津線	カラツセン
女犯	ニョボン
霧	キリ
朝廷	チョウテイ
議員年金	ギインネンキン
三角法	サンカクホウ
噴火	フンカ
精子	セイシ
単細胞生物	タンサイボウセイブツ
漫才師一覧	マンザイシイチラン
金星人	キンセイジン
宇宙人	ウチュウジン
大分市	オオイタシ
神の国発言	カミノクニハツゲン
皇室	コウシツ
王	オウ
黄河文明	コウガブンメイ
駿府	スンプ
出汁	ダシ
超格子	チョウコウシ
状態	ジョウタイ
状態量	ジョウタイリョウ
音律	オンリツ
島原鉄道線	シマバラテツドウセン
人口重心	ジンコウジュウシン
西南戦争	セイナンセンソウ
自由主義国家論	ジユウシュギコッカロン
全一	ゼンイツ
北赤羽駅	キタアカバネエキ
瀬戸内海	セトナイカイ
律令制	リツリョウセイ
企業	キギョウ
酸性	サンセイ
創挙蘭	ソウキョラン
王国	オウコク
東広島駅	ヒガシヒロシマエキ
新尾道駅	シンオノミチエキ
喜劇	キゲキ
両毛線	リョウモウセン
直方晶系	チョクホウショウケイ
正方晶系	セイホウショウケイ
本蘭明朝	ホンランミンチョウ
井原駅	イバラエキ
中河原駅	ナカガワラエキ
海田市駅	カイタイチエキ
瀬野駅	セノエキ
中野東駅	ナカノヒガシエキ
安芸中野駅	アキナカノエキ
向洋駅	ムカイナダエキ
網干駅	アボシエキ
英賀保駅	アガホエキ
紀元前770年	キゲンゼンナナヒャクナナジュウネン
中筋駅	ナカスジエキ
神奈川駅	カナガワエキ
不法行為	フホウコウイ
因原駅	インバラエキ
石見川本駅	イワミカワモトエキ
粕淵駅	カスブチエキ
浜原駅	ハマハラエキ
種子	シュシ
主食	シュショク
球根	キュウコン
脂肪	シボウ
日本三名山	ニホンサンメイザン
不動院前駅	フドウインマエエキ
第二地方銀行	ダイニチホウギンコウ
地方銀行	チホウギンコウ
普通銀行	フツウギンコウ
飯	メシ
呉線	クレセン
玉江駅	タマエエキ
三見駅	サンミエキ
飯井駅	イイエキ
黄波戸駅	キワドエキ
仙崎駅	センザキエキ
糖	トウ
牛丼	ギュウドン
薬剤師	ヤクザイシ
持家派	モチイエハ
北朝鮮による日本人拉致問題	キタチョウセンニヨルニホンジンラチモンダイ
病院	ビョウイン
日本語の乱れ	ニホンゴノミダレ
広駅	ヒロエキ
安芸阿賀駅	アキアガエキ
矢野駅	ヤノエキ
副詞	フクシ
総裁	ソウサイ
妙蓮寺駅	ミョウレンジエキ
銃	ジュウ
消化	ショウカ
重力崩壊	ジュウリョクホウカイ
文字集合	モジシュウゴウ
富国強兵	フコクキョウヘイ
外来語	ガイライゴ
西洋料理	セイヨウリョウリ
根二乗平均速度	コンニジョウヘイキンソクド
販売時点情報管理	ハンバイジテンジョウホウカンリ
桜島	サクラジマ
舞浜駅	マイハマエキ
八丁堀駅	ハッチョウボリエキ
武蔵溝ノ口駅	ムサシミゾノクチエキ
留辺蘂町	ルベシベチョウ
配偶者	ハイグウシャ
長楽寺駅	チョウラクジエキ
上下駅	ジョウゲエキ
甲奴駅	コウヌエキ
粒径	リュウケイ
現代詩	ゲンダイシ
圧密	アツミツ
組版	クミハン
映画監督	エイガカントク
寺社	ジシャ
北海道の分領支配	ホッカイドウノブンリョウシハイ
溝の口駅	ミゾノクチエキ
玉川上水駅	タマガワジョウスイエキ
荏原中延駅	エバラナカノブエキ
制酸薬	セイサンヤク
中延駅	ナカノブエキ
三次方程式	サンジホウテイシキ
中野坂上駅	ナカノサカウエエキ
南魚沼郡	ミナミウオヌマグン
ふじみ野駅	フジミノエキ
熾天使	シテンシ
大津町	オオヅマチ
中華人民共和国の行政区分	チュウカジンミンキョウワコクノギョウセイクブン
強制労働	キョウセイロウドウ
地上権	チジョウケン
和菓子	ワガシ
特別攻撃隊	トクベツコウゲキタイ
小作駅	オザクエキ
斑鳩町	イカルガチョウ
悪魔の階級	アクマノカイキュウ
悪魔憑き	アクマツキ
八八艦隊	ハチハチカンタイ
知恵の樹	チエノキ
正犯	セイハン
お台場海浜公園	オダイバカイヒンコウエン
比較言語学	ヒカクゲンゴガク
中野島駅	ナカノシマエキ
焼きまんじゅう	ヤキマンジュウ
軽羹	カルカン
牧師	ボクシ
対立遺伝子	タイリツイデンシ
病弱児	ビョウジャクジ
岩石	ガンセキ
脾臓	ヒゾウ
北新横浜駅	キタシンヨコハマエキ
岸根公園駅	キシネコウエンエキ
富士見ヶ丘駅	フジミガオカエキ
売春	バイシュン
志木駅	シキエキ
絶滅のおそれのある野生動植物の種の国際取引に関する条約	ゼツメツノオソレノアルヤセイドウショクブツノシュノコクサイトリヒキニカンスルジョウヤク
地獄	ジゴク
煉獄	レンゴク
天国	テンゴク
三沢飛行場	ミサワヒコウジョウ
新有馬駅	シンアリマエキ
時速	ジソク
式敷駅	シキジキエキ
船佐駅	フナサエキ
甲立駅	コウタチエキ
三良坂駅	ミラサカエキ
栄養素	エイヨウソ
弁当	ベントウ
吉舎駅	キサエキ
黒煙	コクエン
水溶液	スイヨウエキ
呉市	クレシ
新京特別市	シンキョウトクベツシ
石狩支庁	イシカリシチョウ
木頭村	キトウソン
守護天使	シュゴテンシ
聖剣	セイケン
香椎線	カシイセン
法華宗	ホッケシュウ
日蓮宗	ニチレンシュウ
直和	チョクワ
味噌汁	ミソシル
制裁戦争	セイサイセンソウ
豆乳	トウニュウ
知事	チジ
自由刑	ジユウケイ
懲役	チョウエキ
科料	カリョウ
器物損壊罪	キブツソンカイザイ
白井駅	シロイエキ
弾丸	ダンガン
禁錮	キンコ
狩猟	シュリョウ
伴駅	トモエキ
苫小牧市	トマコマイシ
名鉄岐阜駅	メイテツギフエキ
多磨霊園駅	タマレイエンエキ
菊川町	キクガワチョウ
京都郡	ミヤコグン
東加茂郡	ヒガシカモグン
西加茂郡	ニシカモグン
北広島市	キタヒロシマシ
精華町	セイカチョウ
日本の宗教家一覧	ニッポンノシュウキョウカイチラン
特異日	トクイビ
沼津市	ヌマヅシ
呉市交通局	クレシコウツウキョク
神戸港	コウベコウ
大航海時代	ダイコウカイジダイ
肉じゃが	ニクジャガ
毘沙門台駅	ビシャモンダイエキ
安東駅	ヤスヒガシエキ
広域公園前駅	コウイキコウエンマエエキ
上安駅	カミヤスエキ
高取駅	タカトリエキ
粟屋駅	アワヤエキ
所木駅	トコロギエキ
信木駅	ノブキエキ
宇都井駅	ウヅイエキ
石見都賀駅	イワミツガエキ
ひたち野うしく駅	ヒタチノウシクエキ
石見松原駅	イワミマツバラエキ
潮駅	ウシオエキ
沢谷駅	サワダニエキ
偕楽園駅	カイラクエンエキ
篠栗線	ササグリセン
江津本町駅	ゴウツホンマチエキ
千金駅	チガネエキ
川平駅	カワヒラエキ
川戸駅	カワドエキ
特例市	トクレイシ
田津駅	タヅエキ
石見川越駅	イワミカワゴエエキ
鹿賀駅	シカガエキ
木路原駅	キロハラエキ
竹駅	タケエキ
石見簗瀬駅	イワミヤナゼエキ
明塚駅	アカツカエキ
福音主義	フクインシュギ
富士見市	フジミシ
道後山駅	ドウゴヤマエキ
小奴可駅	オヌカエキ
自由主義神学	ジユウシュギシンガク
内名駅	ウチナエキ
備後八幡駅	ビンゴヤワタエキ
東城駅	トウジョウエキ
解放の神学	カイホウノシンガク
野馳駅	ノチエキ
矢神駅	ヤガミエキ
市岡駅	イチオカエキ
坂根駅	サカネエキ
比婆山駅	ヒバヤマエキ
平子駅	ヒラコエキ
高駅	タカエキ
間違い探し	マチガイサガシ
備後三日市駅	ビンゴミッカイチエキ
里	リ
高速	コウソク
東本願寺	ヒガシホンガンジ
雷管	ライカン
相続	ソウゾク
火器	カキ
寄生虫	キセイチュウ
楊原村	ヤナギハラムラ
子安駅	コヤスエキ
交通戦争	コウツウセンソウ
浅草寺	センソウジ
博覧会	ハクランカイ
観光地	カンコウチ
爆発	バクハツ
紫外線	シガイセン
須賀駅	スカエキ
南宿駅	ミナミジュクエキ
酒米	サカマイ
農産物	ノウサンブツ
呼吸	コキュウ
溜池山王駅	タメイケサンノウエキ
有機農産物	ユウキノウサンブツ
電気通信大学	デンキツウシンダイガク
餡	アン
西三次駅	ニシミヨシエキ
八次駅	ヤツギエキ
神杉駅	カミスギエキ
三島市	ミシマシ
北足立郡	キタアダチグン
香貫山	カヌキヤマ
入間郡	イルマグン
沼津御用邸	ヌマヅゴヨウテイ
北埼玉郡	キタサイタマグン
南埼玉郡	ミナミサイタマグン
北葛飾郡	キタカツシカグン
騎士	キシ
丹波町	タンバチョウ
白木山駅	シラキヤマエキ
中三田駅	ナカミタエキ
上三田駅	カミミタエキ
井原市駅	イバライチエキ
向原駅	ムカイハラエキ
上川立駅	カミカワタチエキ
志和地駅	シワチエキ
下和知駅	シモワチエキ
七塚駅	ナナツカエキ
我入道	ガニュウドウ
座	ザ
聖書の登場人物の一覧	セイショノトウジョウジンブツノイチラン
備後安田駅	ビンゴヤスダエキ
梶田駅	カジタエキ
備後矢野駅	ビンゴヤノエキ
備後三川駅	ビンゴミカワエキ
河佐駅	カワサエキ
尊師	ソンシ
下川辺駅	シモカワベエキ
聖餐	セイサン
沼津港	ヌマヅコウ
沼津駅	ヌマヅエキ
悪魔学	アクマガク
田儀駅	タギエキ
都野津駅	ツノヅエキ
敬川駅	ウヤガワエキ
聖堂	セイドウ
浅利駅	アサリエキ
石見福光駅	イワミフクミツエキ
馬路駅	マジエキ
流出説	リュウシュツセツ
久代駅	クシロエキ
下府駅	シモコウエキ
西浜田駅	ニシハマダエキ
周布駅	スフエキ
折居駅	オリイエキ
岡見駅	オカミエキ
鎌手駅	カマテエキ
石見津田駅	イワミツダエキ
戸田小浜駅	トダコハマエキ
飯浦駅	イイノウラエキ
五十猛駅	イソタケエキ
静間駅	シズマエキ
久手駅	クテエキ
波根駅	ハネエキ
日田彦山線	ヒタヒコサンセン
後藤寺線	ゴトウジセン
西谷駅	ニシヤエキ
浜名湖	ハマナコ
浅草	アサクサ
仙台藩	センダイハン
2階建車両	ニカイダテシャリョウ
刺身	サシミ
公家	クゲ
沼津城	ヌマヅジョウ
千本松原	センボンマツバラ
首長	シュチョウ
北池袋駅	キタイケブクロエキ
太市駅	オオイチエキ
余部駅	ヨベエキ
播磨高岡駅	ハリマタカオカエキ
西広島駅	ニシヒロシマエキ
宮内串戸駅	ミヤウチクシドエキ
宮島口駅	ミヤジマグチエキ
前空駅	マエゾラエキ
大野浦駅	オオノウラエキ
火星探査機	カセイタンサキ
維管束	イカンソク
海軍	カイグン
東洋	トウヨウ
蒲郡市	ガマゴオリシ
城下町	ジョウカマチ
長泉町	ナガイズミチョウ
黄瀬川	キセガワ
河北郡	カホクグン
豚カツ	トンカツ
異端	イタン
異端審問	イタンシンモン
丼鉢	ドンブリバチ
大和西大寺駅	ヤマトサイダイジエキ
午後の死	ゴゴノシ
伊賀上野駅	イガウエノエキ
柘植駅	ツゲエキ
新堂駅	シンドウエキ
佐那具駅	サナグエキ
島ケ原駅	シマガハラエキ
月ケ瀬口駅	ツキガセグチエキ
笠置駅	カサギエキ
福知山駅	フクチヤマエキ
西舞鶴駅	ニシマイヅルエキ
綾部駅	アヤベエキ
料理酒	リョウリシュ
文明開化	ブンメイカイカ
無線呼び出し	ムセンヨビダシ
格	カク
助詞	ジョシ
油日駅	アブラヒエキ
甲賀駅	コウカエキ
寺庄駅	テラショウエキ
甲南駅	コウナンエキ
自由度	ジユウド
貴生川駅	キブカワエキ
三雲駅	ミクモエキ
甲西駅	コウセイエキ
石部駅	イシベエキ
手原駅	テハラエキ
東関東方言	ヒガシカントウホウゲン
作業療法	サギョウリョウホウ
浦和市	ウラワシ
与野市	ヨノシ
利き手	キキテ
深夜番組	シンヤバングミ
さいたま新都心駅	サイタマシントシンエキ
人工透析	ジンコウトウセキ
両利き	リョウキキ
老人性認知症	ロウジンセイニンチショウ
脳卒中	ノウソッチュウ
予防	ヨボウ
津駅	ツエキ
河原田駅	カワラダエキ
松阪駅	マツサカエキ
鳥羽駅	トバエキ
上野市駅	ウエノシエキ
新居駅	ニイエキ
西大手駅	ニシオオテエキ
広小路駅	ヒロコウジエキ
茅町駅	カヤマチエキ
桑町駅	クワマチエキ
猪田道駅	イダミチエキ
市部駅	イチベエキ
依那古駅	イナコエキ
上林駅	ウエバヤシエキ
比土駅	ヒドエキ
伊賀神戸駅	イガカンベエキ
美旗駅	ミハタエキ
授権資本制度	ジュケンシホンセイド
相模川	サガミガワ
島原市	シマバラシ
6次産業	ロクジサンギョウ
吉原市	ヨシワラシ
内灘町	ウチナダマチ
神経	シンケイ
桔梗が丘駅	キキョウガオカエキ
名張駅	ナバリエキ
赤目口駅	アカメグチエキ
青山町駅	アオヤマチョウエキ
伊賀上津駅	イガコウヅエキ
西青山駅	ニシアオヤマエキ
東青山駅	ヒガシアオヤマエキ
榊原温泉口駅	サカキバラオンセングチエキ
大三駅	オオミツエキ
伊勢石橋駅	イセイシバシエキ
川合高岡駅	カワイタカオカエキ
伊勢中川駅	イセナカガワエキ
多気駅	タキエキ
新広駅	シンヒロエキ
長州藩	チョウシュウハン
鶴見川	ツルミガワ
漬物	ツケモノ
伊東線	イトウセン
つくば市	ツクバシ
伊豆急行線	イズキュウコウセン
西武園駅	セイブエンエキ
超能力	チョウノウリョク
地球連邦	チキュウレンポウ
桑名駅	クワナエキ
新しい人権	アタラシイジンケン
成年後見制度	セイネンコウケンセイド
保佐	ホサ
方言字	ホウゲンジ
天皇機関説事件	テンノウキカンセツジケン
華人	カジン
脳神経	ノウシンケイ
日本の寺院一覧	ニホンノジインイチラン
歌人一覧	カジンイチラン
桃園駅	モモゾノエキ
南が丘駅	ミナミガオカエキ
津新町駅	ツシンマチエキ
汚職	オショク
江戸橋駅	エドバシエキ
屯田予備兵	トンデンヨビヘイ
執権	シッケン
大勲位菊花章頸飾	ダイクンイキッカショウケイショク
衣替え	コロモガエ
動物園	ドウブツエン
黒海	コッカイ
色丹島	シコタントウ
利尻島	リシリトウ
礼文島	レブントウ
厚木秦野道路	アツギハダノドウロ
試験	シケン
函館新道	ハコダテシンドウ
普通裁判籍	フツウサイバンセキ
普通	フツウ
音中道路	オトナカドウロ
高田本山駅	タカダホンザンエキ
東一身田駅	ヒガシイシンデンエキ
一身田駅	イシンデンエキ
白塚駅	シラツカエキ
豊津上野駅	トヨツウエノエキ
磯山駅	イソヤマエキ
鼓ヶ浦駅	ツヅミガウラエキ
千代崎駅	チヨザキエキ
伊勢若松駅	イセワカマツエキ
箕田駅	ミダエキ
長太ノ浦駅	ナゴノウラエキ
北楠駅	キタクスエキ
塩浜駅	シオハマエキ
海山道駅	ミヤマドエキ
新正駅	シンショウエキ
阿倉川駅	アクラガワエキ
霞ヶ浦駅	カスミガウラエキ
川越富洲原駅	カワゴエトミスハラエキ
伊勢朝日駅	イセアサヒエキ
益生駅	マスオエキ
近鉄長島駅	キンテツナガシマエキ
本願寺道路	ホンガンジドウロ
近鉄弥富駅	キンテツヤトミエキ
佐古木駅	サコギエキ
近鉄蟹江駅	キンテツカニエエキ
伏屋駅	フシヤエキ
近鉄八田駅	キンテツハッタエキ
烏森駅	カスモリエキ
米野駅	コメノエキ
伊勢中原駅	イセナカハラエキ
違憲審査基準	イケンシンサキジュン
東松阪駅	ヒガシマツサカエキ
櫛田駅	クシダエキ
漕代駅	コイシロエキ
斎宮駅	サイクウエキ
明星駅	ミョウジョウエキ
一志駅	イチシエキ
柳駅	ヤナギエキ
鈴鹿市駅	スズカシエキ
三日市駅	ミッカイチエキ
平田町駅	ヒラタチョウエキ
薔薇戦争	バラセンソウ
不耕起栽培	フコウキサイバイ
冬期湛水	トウキタンスイ
慢性硬膜下血腫	マンセイコウマクカケッシュ
租税法律主義	ソゼイホウリツシュギ
学芸員	ガクゲイイン
徽宗	キソウ
強化人間	キョウカニンゲン
三藩の乱	サンパンノラン
詰み	ツミ
入玉	ニュウギョク
先手	センテ
後手	ゴテ
振り駒	フリゴマ
将棋の手合割	ショウギノテアイワリ
事件	ジケン
北半球	キタハンキュウ
上場	ジョウジョウ
汽水魚	キスイギョ
気管内吸引	キカンナイキュウイン
接種	セッシュ
学術用語	ガクジュツヨウゴ
栄駅	サカエエキ
鏡	カガミ
運河駅	ウンガエキ
反射	ハンシャ
天地無用	テンチムヨウ
筑豊電気鉄道線	チクホウデンキテツドウセン
不動産	フドウサン
新居浜市	ニイハマシ
表定速度	ヒョウテイソクド
地盤調査	ジバンチョウサ
外国税額控除制度	ガイコクゼイガクコウジョセイド
武帝	ブテイ
合成繊維	ゴウセイセンイ
大坂の陣	オオサカノジン
営業の自由	エイギョウノジユウ
名水百選	メイスイヒャクセン
一事不再理	イチジフサイリ
嗅神経	キュウシンケイ
双方代理	ソウホウダイリ
赤城駅	アカギエキ
城東駅	ジョウトウエキ
三俣駅	ミツマタエキ
片貝駅	カタカイエキ
上泉駅	カミイズミエキ
江木駅	エギエキ
大胡駅	オオゴエキ
樋越駅	ヒゴシエキ
北原駅	キタハラエキ
粕川駅	カスカワエキ
膳駅	ゼンエキ
天王宿駅	テンノウジュクエキ
丸山下駅	マルヤマシタエキ
西桐生駅	ニシキリュウエキ
神保原駅	ジンボハラエキ
関東の駅百選	カントウノエキヒャクセン
飛鳥山公園	アスカヤマコウエン
近畿の駅百選	キンキノエキヒャクセン
併用軌道	ヘイヨウキドウ
片浜村	カタハマムラ
中部の駅百選	チュウブノエキヒャクセン
愛鷹村	アシタカムラ
伊豆長岡町	イズナガオカチョウ
東北の駅百選	トウホクノエキヒャクセン
歴史哲学	レキシテツガク
油彩	ユサイ
相老駅	アイオイエキ
新桐生駅	シンキリュウエキ
江の島	エノシマ
河北潟	カホクガタ
蒸気	ジョウキ
版籍奉還	ハンセキホウカン
三浦半島	ミウラハントウ
傷病	ショウビョウ
慶長	ケイチョウ
角川書店	カドカワショテン
津幡町	ツバタマチ
商業	ショウギョウ
失神	シッシン
富士五湖	フジゴコ
山中湖	ヤマナカコ
光過敏性発作	ヒカリカビンセイホッサ
毒素	ドクソ
悪臭	アクシュウ
大気汚染	タイキオセン
有限会社	ユウゲンガイシャ
伊豆諸島	イズショトウ
伊豆大島	イズオオシマ
利島	トシマ
新島	ニイジマ
神津島	コウヅシマ
東鷹栖町	ヒガシタカスチョウ
外国馬	ガイコクバ
天体の出没	テンタイノシュツボツ
日没	ニチボツ
外国産馬	ガイコクサンバ
三宅島	ミヤケジマ
御蔵島	ミクラジマ
笠松駅	カサマツエキ
芝居	シバイ
阿左美駅	アザミエキ
使い魔	ツカイマ
小節	ショウセツ
全音階	ゼンオンカイ
質量数	シツリョウスウ
熱傷	ネッショウ
小笠原諸島	オガサワラショトウ
木枯らし	コガラシ
全音	ゼンオン
万年筆	マンネンヒツ
主音	シュオン
歯舞群島	ハボマイグントウ
臨時記号	リンジキゴウ
調号	チョウゴウ
世紀末	セイキマツ
変化記号	ヘンカキゴウ
紀元前2千年紀	キゲンゼンニセンネンキ
紀元前1千年紀	キゲンゼンイッセンネンキ
目黒競馬場	メグロケイバジョウ
砂丘	サキュウ
阿寒湖	アカンコ
関係調	カンケイチョウ
上川支庁	カミカワシチョウ
石狩川	イシカリガワ
旭川空港	アサヒカワクウコウ
北習志野駅	キタナラシノエキ
屈斜路湖	クッシャロコ
固定電話	コテイデンワ
西笠松駅	ニシカサマツエキ
潮汐	チョウセキ
支笏湖	シコツコ
洞爺湖	トウヤコ
純正律	ジュンセイリツ
破産手続開始の原因	ハサンテツヅキカイシノゲンイン
銭湯	セントウ
公衆浴場	コウシュウヨクジョウ
拳銃	ケンジュウ
機関銃	キカンジュウ
小銃	ショウジュウ
複合三部形式	フクゴウサンブケイシキ
三部形式	サンブケイシキ
短機関銃	タンキカンジュウ
梅干し	ウメボシ
特攻隊	トッコウタイ
地殻	チカク
東笠松駅	ヒガシカサマツエキ
菜の花	ナノハナ
越ケ浜駅	コシガハマエキ
長門大井駅	ナガトオオイエキ
破産手続開始の申立て	ハサンテツヅキカイシノモウシタテ
身延駅	ミノブエキ
羽島市	ハシマシ
江戸川	エドガワ
医療事故	イリョウジコ
甲州街道	コウシュウカイドウ
四声	シセイ
痙攣	ケイレン
水産業	スイサンギョウ
畜産	チクサン
立法府	リッポウフ
鷹の爪	タカノツメ
豊平川	トヨヒラガワ
医療過誤	イリョウカゴ
阿含宗	アゴンシュウ
世界救世教	セカイキュウセイキョウ
霊友会	シュウキョウホウジンレイユウカイ
殉教	ジュンキョウ
鷹栖町	タカスチョウ
東神楽町	ヒガシカグラチョウ
律令	リツリョウ
荘園	ショウエン
古代	コダイ
中世	チュウセイ
近世	キンセイ
現代	ゲンダイ
人間宣言	ニンゲンセンゲン
清和源氏	セイワゲンジ
軍事貴族	グンジキゾク
三浦海岸駅	ミウラカイガンエキ
下関市	シモノセキシ
下関戦争	シモノセキセンソウ
岐南駅	ギナンエキ
士別市	シベツシ
名寄市	ナヨロシ
富良野市	フラノシ
自動車電話	ジドウシャデンワ
鍋料理	ナベリョウリ
都庁前駅	トチョウマエエキ
船舶電話	センパクデンワ
麹	コウジ
竹鼻駅	タケハナエキ
支笏洞爺国立公園	シコツトウヤコクリツコウエン
石器時代	セッキジダイ
電気伝導率	デンキデンドウリツ
大雪山国立公園	ダイセツザンコクリツコウエン
旭岳	アサヒダケ
高齢者福祉	コウレイシャフクシ
駆逐艦	クチクカン
焼肉	ヤキニク
仙台城	センダイジョウ
故意	コイ
総則	ソウソク
応急処置	オウキュウショチ
同時履行の抗弁権	ドウジリコウノコウベンケン
中間子	チュウカンシ
山芋	ヤマイモ
室蘭本線	ムロランホンセン
人民元	ジンミンゲン
当麻町	トウマチョウ
日本の警察	ニホンノケイサツ
大隅諸島	オオスミショトウ
沖縄諸島	オキナワショトウ
大東諸島	ダイトウショトウ
尖閣諸島	センカクショトウ
天売島	テウリトウ
焼尻島	ヤギシリトウ
暑寒別天売焼尻国定公園	ショカンベツテウリヤギシリコクテイコウエン
藤原氏	フジワラシ
元素の周期	ゲンソノシュウキ
伊藤整文学賞	イトウセイブンガクショウ
姓氏	セイシ
比布町	ピップチョウ
海底	カイテイ
愛別町	アイベツチョウ
共有結合半径	キョウユウケツゴウハンケイ
釜石市	カマイシシ
塩竈市	シオガマシ
多賀城市	タガジョウシ
電子配置	デンシハイチ
酸化数	サンカスウ
特牛駅	コットイエキ
対馬海峡	ツシマカイキョウ
透水性	トウスイセイ
岩国市	イワクニシ
小野田市	オノダシ
破産宣告	ハサンセンコク
長門市	ナガトシ
戸越公園駅	トゴシコウエンエキ
定理	テイリ
熱電対	ネツデンツイ
馬鹿	バカ
拘留	コウリュウ
関東軍	カントウグン
戦略爆撃機	センリャクバクゲキキ
特別地方公共団体	トクベツチホウコウキョウダンタイ
励起子	レイキシ
基本粒子	キホンリュウシ
箕面市	ミノオシ
黒い聖母	クロイセイボ
元素の分類	ゲンソノブンルイ
標準状態	ヒョウジュンジョウタイ
犬山市	イヌヤマシ
上川町	カミカワチョウ
東川町	ヒガシカワチョウ
美瑛町	ビエイチョウ
武生市	タケフシ
列島	レットウ
海峡	カイキョウ
亀甲縛り	キッコウシバリ
緊縛	キンバク
立山杉	タテヤマスギ
軽井沢	カルイザワ
補助機関車	ホジョキカンシャ
碓氷峠鉄道文化むら	ウスイトウゲテツドウブンカムラ
羅切	ラセツ
宮刑	キュウケイ
くノ一	クノイチ
男性器	ダンセイキ
比	ヒ
除法	ジョホウ
寝台券	シンダイケン
刑罰の一覧	ケイバツノイチラン
日本列島の旧石器時代	ニホンレットウノキュウセッキジダイ
裁判官弾劾裁判所	サイバンカンダンガイサイバンショ
骨	ホネ
男性恐怖症	ダンセイキョウフショウ
九十九里浜	クジュウクリハマ
島原の乱	シマバラノラン
聖杯	セイハイ
鷲	ワシ
福光町	フクミツマチ
花壇橋	カダンバシ
皮膚	ヒフ
総社市	ソウジャシ
笠岡市	カサオカシ
渡島大島	オシマオオシマ
連結納税	レンケツノウゼイ
評定河原橋	ヒョウジョウガワラバシ
霊屋橋	オタマヤバシ
会社分割	カイシャブンカツ
現物出資	ゲンブツシュッシ
浦添市	ウラソエシ
壱岐島	イキノシマ
平民社	ヘイミンシャ
日光国立公園	ニッコウコクリツコウエン
破産債権	ハサンサイケン
茶巾	チャキン
創唱宗教	ソウショウシュウキョウ
核子	カクシ
律法	リッポウ
事後設立	ジゴセツリツ
株式移転	カブシキイテン
株式交換	カブシキコウカン
区	ク
飯能市	ハンノウシ
速達	ソクタツ
再生医学	サイセイイガク
荒川一中前停留場	アラカワイッチュウマエテイリュウジョウ
拘縮	コウシュク
犬山城	イヌヤマジョウ
明野駅	アケノエキ
宇治山田駅	ウジヤマダエキ
五十鈴川駅	イスズガワエキ
朝熊駅	アサマエキ
池の浦駅	イケノウラエキ
中之郷駅	ナカノゴウエキ
志摩赤崎駅	シマアカサキエキ
白木駅	シラキエキ
五知駅	ゴチエキ
沓掛駅	クツカケエキ
上之郷駅	カミノゴウエキ
志摩磯部駅	シマイソベエキ
志摩横山駅	シマヨコヤマエキ
志摩神明駅	シマシンメイエキ
賢島駅	カシコジマエキ
富士市	フジシ
法要	ホウヨウ
卸売	オロシウリ
放送局	ホウソウキョク
山脈	サンミャク
医学教育	イガクキョウイク
山地	サンチ
扇状地	センジョウチ
手稲区	テイネク
江別市	エベツシ
破産財団	ハサンザイダン
公共法人	コウキョウホウジン
公益法人等	コウエキホウジントウ
不対電子	フツイデンシ
性格	セイカク
和寒町	ワッサムチョウ
武道	ブドウ
演出家	エンシュツカ
演出	エンシュツ
神奈川区	カナガワク
磯子区	イソゴク
日本二十六聖人	ニホンニジュウロクセイジン
洗礼名	センレイメイ
権利	ケンリ
剣淵町	ケンブチチョウ
赤瀾会	セキランカイ
田丸駅	タマルエキ
宮川駅	ミヤガワエキ
五十鈴ケ丘駅	イスズガオカエキ
二見浦駅	フタミノウラエキ
相可駅	オウカエキ
佐奈駅	サナエキ
徳和駅	トクワエキ
高茶屋駅	タカチャヤエキ
阿漕駅	アコギエキ
下庄駅	シモノショウエキ
井田川駅	イダガワエキ
加佐登駅	カサドエキ
河曲駅	カワノエキ
南四日市駅	ミナミヨッカイチエキ
玉垣駅	タマガキエキ
河芸駅	カワゲエキ
障害	ショウガイ
過少資本税制	カショウシホンゼイセイ
明朝体	ミンチョウタイ
移転価格税制	イテンカカクゼイセイ
時刻系	ジコクケイ
怪獣映画	カイジュウエイガ
風連町	フウレンチョウ
概念法学	ガイネンホウガク
梁瀬駅	ヤナセエキ
上夜久野駅	カミヤクノエキ
下夜久野駅	シモヤクノエキ
上川口駅	カミカワグチエキ
養父駅	ヤブエキ
八鹿駅	ヨウカエキ
江原駅	エバラエキ
玄武洞駅	ゲンブドウエキ
竹野駅	タケノエキ
佐津駅	サツエキ
柴山駅	シバヤマエキ
香住駅	カスミエキ
引当金	ヒキアテキン
鎧駅	ヨロイエキ
餘部駅	アマルベエキ
久谷駅	クタニエキ
三崎口駅	ミサキグチエキ
浜坂駅	ハマサカエキ
諸寄駅	モロヨセエキ
居組駅	イグミエキ
山家駅	ヤマガエキ
立木駅	タチキエキ
安栖里駅	アセリエキ
和知駅	ワチエキ
純粋法学	ジュンスイホウガク
川辺宿駅	カワベジュクエキ
備中呉妹駅	ビッチュウクレセエキ
眼鏡橋	メガネバシ
いずえ駅	イズエエキ
子守唄の里高屋駅	コモリウタノサトタカヤエキ
湯野駅	ユノエキ
植皮	ショクヒ
拘束衣	コウソクイ
本直し	ホンナオシ
展望車	テンボウシャ
法解釈	ホウカイシャク
臨時列車	リンジレッシャ
日本の学会一覧	ニホンノガッカイイチラン
瘢痕	ハンコン
創傷	ソウショウ
希望ヶ丘駅	キボウガオカエキ
大修館書店	タイシュウカンショテン
案内軌条式鉄道	アンナイキジョウシキテツドウ
花道	ハナミチ
湿度	シツド
白根市	シロネシ
楽章	ガクショウ
私講師	シコウシ
功利主義	コウリシュギ
宜野湾市	ギノワンシ
中央軍集団	チュウオウグンシュウダン
柳井市	ヤナイシ
美祢市	ミネシ
下土狩駅	シモトガリエキ
新世紀	シンセイキ
主演	シュエン
鶴岡市	ツルオカシ
甲府市	コウフシ
松江市	マツエシ
大津市	オオツシ
和歌山市	ワカヤマシ
宇治市	ウジシ
氷河時代	ヒョウガジダイ
北海道方言	ホッカイドウホウゲン
物性量	ブッセイリョウ
池野駅	イケノエキ
天塩川	テシオガワ
石勝線	セキショウセン
憂国忌	ユウコクキ
高岡郡	タカオカグン
八戸久慈自動車道	ハチノヘクジジドウシャドウ
三陸縦貫自動車道	サンリクジュウカンジドウシャドウ
見当識	ケントウシキ
中国大陸	チュウゴクタイリク
留萌川	ルモイガワ
国境	コッキョウ
直行便	チョッコウビン
音符	オンプ
朝霞駅	アサカエキ
銀座駅	ギンザエキ
子宮	シキュウ
山陰地方	サンインチホウ
宝蔵院流槍術	ホウゾウインリュウソウジュツ
台湾職業棒球大聯盟	タイワンショクギョウボウキュウダイレンメイ
獏	バク
剱岳	ツルギダケ
賽	サイ
羊蹄山	ヨウテイザン
結婚	ケッコン
外国倒産処理手続	ガイコクトウサンショリテツヅキ
煮干し	ニボシ
怪人二十面相	カイジンニジュウメンソウ
剣術	ケンジュツ
柳生新陰流	ヤギュウシンカゲリュウ
古武道	コブドウ
対馬府中藩	ツシマフチュウハン
鹿野藩	シカノハン
津和野藩	ツワノハン
十勝川	トカチガワ
大化	タイカ
保土ケ谷区	ホドガヤク
茶漬け	チャヅケ
方位	ホウイ
若桜藩	ワカサハン
鳥取藩	トットリハン
過失	カシツ
取消し	トリケシ
修道会	シュウドウカイ
天塩郡	テシオグン
清末藩	キヨスエハン
大聖寺藩	ダイショウジハン
高須藩	タカスハン
西条藩	サイジョウハン
佐土原藩	サドワラハン
石狩岳	イシカリダケ
道の駅	ミチノエキ
福江藩	フクエハン
外様大名	トザマダイミョウ
米子市	ヨナゴシ
出雲市	イズモシ
倉吉市	クラヨシシ
鳥取市	トットリシ
伊予吉田藩	イヨヨシダハン
航路	コウロ
のと里山海道	ノトサトヤマカイドウ
二重結合	ニジュウケツゴウ
三重結合	サンジュウケツゴウ
橿原市	カシハラシ
五條市	ゴジョウシ
桜井市	サクライシ
御所市	ゴセシ
香芝市	カシバシ
月ヶ瀬村	ツキガセムラ
十津川村	トツカワムラ
輸血	ユケツ
津山市	ツヤマシ
血液型占い	ケツエキガタウラナイ
新秋津駅	シンアキツエキ
岩美郡	イワミグン
気高郡	ケタカグン
西伯郡	サイハクグン
八束郡	ヤツカグン
能義郡	ノギグン
仁多郡	ニタグン
大原郡	オオハラグン
飯石郡	イイシグン
簸川郡	ヒカワグン
隠岐郡	オキグン
郡	グン
洞戸村	ホラドムラ
再結晶	サイケッショウ
羽島郡	ハシマグン
笠松町	カサマツチョウ
支庁	シチョウ
光学異性体	コウガクイセイタイ
配位結合	ハイイケツゴウ
円相場	エンソウバ
南九州西回り自動車道	ミナミキュウシュウニシマワリジドウシャドウ
星雲	セイウン
外惑星	ガイワクセイ
圧縮率	アッシュクリツ
武蔵野台駅	ムサシノダイエキ
権利能力	ケンリノウリョク
名古屋高速道路	ナゴヤコウソクドウロ
奈良駅	ナラエキ
州	シュウ
楽寿園	ラクジュエン
地域	チイキ
標語	ヒョウゴ
空知郡	ソラチグン
勇払郡	ユウフツグン
虻田郡	アブタグン
靱性	ジンセイ
独裁者	ドクサイシャ
静電気	セイデンキ
田園調布駅	デンエンチョウフエキ
天狗	テング
箱根新道	ハコネシンドウ
山伏	ヤマブシ
電子辞書	デンシジショ
藪塚駅	ヤブヅカエキ
白川村	シラカワムラ
水沢競馬場	ミズサワケイバジョウ
大牟田市	オオムタシ
種牡馬	シュボバ
下川町	シモカワチョウ
東広島市	ヒガシヒロシマシ
千歳線	チトセセン
豊橋駅	トヨハシエキ
逗葉新道	ズヨウシンドウ
長島町	ナガシマチョウ
南知多道路	ミナミチタドウロ
変分原理	ヘンブンゲンリ
竜王町	リュウオウチョウ
月見	ツキミ
藻岩山観光自動車道	モイワヤマカンコウジドウシャドウ
公立諏訪東京理科大学	コウリツスワトウキョウリカダイガク
岡山理科大学	オカヤマリカダイガク
五虎大将軍	ゴコダイショウグン
大学	ダイガク
福山市	フクヤマシ
水責め	ミズゼメ
脆性	ゼイセイ
公共企業体	コウキョウキギョウタイ
鹿島臨海工業地帯	カシマリンカイコウギョウチタイ
木曽川	キソガワ
関ケ原町	セキガハラチョウ
知多横断道路	チタオウダンドウロ
強度	キョウド
酸化	サンカ
化学反応式	カガクハンノウシキ
ひよどり山有料道路	ヒヨドリヤマユウリョウドウロ
稲城大橋	イナギオオハシ
宗教法人	シュウキョウホウジン
三浦市	ミウラシ
譜代大名	フダイダイミョウ
丹羽郡	ニワグン
葉栗郡	ハグリグン
京田辺駅	キョウタナベエキ
伺候席	シコウセキ
比叡山	ヒエイザン
知多郡	チタグン
幡豆郡	ハズグン
延暦寺	エンリャクジ
宝飯郡	ホイグン
北設楽郡	キタシタラグン
金属樹	キンゾクジュ
鬼門	キモン
佃煮	ツクダニ
横浜新道	ヨコハマシンドウ
足利銀行	アシカガギンコウ
墓	ハカ
予防接種	ヨボウセッシュ
地上天気図	チジョウテンキズ
中央分離帯	チュウオウブンリタイ
益田市	マスダシ
浜田市	ハマダシ
平田市	ヒラタシ
江津市	ゴウツシ
備前市	ビゼンシ
人身御供	ヒトミゴクウ
太陽政策	タイヨウセイサク
軸受	ジクウケ
反日感情	ハンニチカンジョウ
文化大革命	ブンカダイカクメイ
柴漬	フシヅケ
一般道路	イッパンドウロ
有料道路	ユウリョウドウロ
荷重たわみ温度	カジュウタワミオンド
自動車道	ジドウシャドウ
自動車専用道路	ジドウシャセンヨウドウロ
都市高速道路	トシコウソクドウロ
熊本城	クマモトジョウ
菊水作戦	キクスイサクセン
大社町	タイシャマチ
地方三新法	チホウサンシンポウ
姫路競馬場	ヒメジケイバジョウ
韓国映画	カンコクエイガ
交通弱者	コウツウジャクシャ
本能	ホンノウ
空知支庁	ソラチシチョウ
後志支庁	シリベシシチョウ
渡島支庁	オシマシチョウ
檜山支庁	ヒヤマシチョウ
胆振支庁	イブリシチョウ
滝沢市	タキザワシ
本州四国連絡道路	ホンシュウシコクレンラクドウロ
日高支庁	ヒダカシチョウ
留萌支庁	ルモイシチョウ
宗谷支庁	ソウヤシチョウ
網走支庁	アバシリシチョウ
十勝支庁	トカチシチョウ
根室支庁	ネムロシチョウ
釧路支庁	クシロシチョウ
普通法人	フツウホウジン
成文法	セイブンホウ
繰り込み	クリコミ
東京箱根間往復大学駅伝競走	トウキョウハコネカンオウフクダイガクエキデンキョウソウ
方位神	ホウイジン
芸能事務所	ゲイノウジムショ
牛歩戦術	ギュウホセンジュツ
日本の劇団一覧	ニホンノゲキダンイチラン
第三舞台	ダイサンブタイ
対消滅	ツイショウメツ
非戦論	ヒセンロン
もんじゃ焼き	モンジャヤキ
佐渡市	サドシ
屋台	ヤタイ
天元戦	テンゲンセン
明晰夢	メイセキム
美術評論家	ビジュツヒョウロンカ
大岡村	オオオカムラ
山彦	ヤマビコ
鼻	ハナ
豊明市	トヨアケシ
高齢者	コウレイシャ
三次市	ミヨシシ
日本統治時代の台湾	ニホントウチジダイノタイワン
福岡高速道路	フクオカコウソクドウロ
北九州高速道路	キタキュウシュウコウソクドウロ
広島高速道路	ヒロシマコウソクドウロ
開発独裁	カイハツドクサイ
熱帯低気圧	ネッタイテイキアツ
広告	コウコク
甲府駅	コウフエキ
製造に関する記事一覧	セイゾウニカンスルキジイチラン
前戯	ゼンギ
土佐市	トサシ
龍野市	タツノシ
水彩	スイサイ
富士河口湖町	フジカワグチコマチ
居間	イマ
新石器時代	シンセッキジダイ
移調楽器	イチョウガッキ
株式持ち合い	カブシキモチアイ
めじろ台駅	メジロダイエキ
株主平等の原則	カブヌシビョウドウノゲンソク
文字化け	モジバケ
蒙古	モウコ
道具	ドウグ
黒死病	コクシビョウ
周期律	シュウキリツ
言霊	コトダマ
相互確証破壊	ソウゴカクショウハカイ
国民党	コクミントウ
量子論	リョウシロン
台湾国民党	タイワンコクミントウ
五十音順	ゴジュウオンジュン
無主物先占	ムシュブツセンセン
茎	クキ
花序	カジョ
寄附行為	キフコウイ
養液栽培	ヨウエキサイバイ
土佐藩	トサハン
斐川町	ヒカワチョウ
可塑剤	カソザイ
藁	ワラ
渋沢駅	シブサワエキ
陸軍	リクグン
壱岐市	イキシ
養液土耕	ヨウエキドコウ
対馬市	ツシマシ
立ち泳ぎ	タチオヨギ
隠岐の島町	オキノシマチョウ
図面	ズメン
還元	カンゲン
法律要件	ホウリツヨウケン
参議院全国区	サンギインゼンコクク
建築確認申請	ケンチクカクニンシンセイ
相原駅	アイハラエキ
上白糖	ジョウハクトウ
鳥取空港	トットリクウコウ
茹で物	ユデモノ
徐州市	ジョシュウシ
破産犯罪	ハサンハンザイ
油脂	ユシ
小川町	オガワマチ
乾物	カンブツ
電気機関車	デンキキカンシャ
核抑止	カクヨクシ
歩行者	ホコウシャ
中立進化説	チュウリツシンカセツ
本巣市	モトスシ
高松市	タカマツシ
国際連合児童基金	コクサイレンゴウジドウキキン
かほく市	カホクシ
東武博物館	トウブハクブツカン
統監府	トウカンフ
嗜好品	シコウヒン
植物工場	ショクブツコウジョウ
戦争責任	センソウセキニン
四股名	シコナ
清涼飲料水	セイリョウインリョウスイ
謀叛	ムホン
炭酸飲料	タンサンインリョウ
置換反応	チカンハンノウ
成駒	ナリゴマ
軽食	ケイショク
紀元前14世紀	キゲンゼンジュウヨンセイキ
紀元前15世紀	キゲンゼンジュウゴセイキ
紀元前16世紀	キゲンゼンジュウロクセイキ
瀬戸市	セトシ
小田原市	オダワラシ
淡色野菜	タンショクヤサイ
灰汁	アク
紀元	キゲン
西瀬戸自動車道	ニシセトジドウシャドウ
瀬戸大橋	セトオオハシ
あわら市	アワラシ
星型正多面体	ホシガタセイタメンタイ
安芸高田市	アキタカタシ
界面活性剤	カイメンカッセイザイ
摩擦帯電	マサツタイデン
花と狼の帝国	ハナトオオカミノテイコク
西馬込駅	ニシマゴメエキ
高等裁判所	コウトウサイバンショ
懸濁液	ケンダクエキ
会計	カイケイ
弦楽四重奏	ゲンガクシジュウソウ
棋譜	キフ
米原駅	マイバラエキ
精神安定剤	セイシンアンテイザイ
渋川市	シブカワシ
阪急百貨店	ハンキュウヒャッカテン
阪神百貨店	ハンシンヒャッカテン
大丸	ダイマル
弓道	キュウドウ
心臓発作	シンゾウホッサ
近鉄百貨店	キンテツヒャッカテン
互先	タガイセン
生態学	セイタイガク
筑紫野市	チクシノシ
伊勢丹	イセタン
等高線	トウコウセン
等圧面	トウアツメン
松坂屋	マツザカヤ
安佐南区	アサミナミク
安佐北区	アサキタク
気体分子運動論	キタイブンシウンドウロン
多様性	タヨウセイ
西武百貨店	セイブヒャッカテン
東武百貨店	トウブヒャッカテン
確率分布	カクリツブンプ
東急百貨店	トウキュウヒャッカテン
準拠法	ジュンキョホウ
京急百貨店	ケイキュウヒャッカテン
小田急百貨店	オダキュウヒャッカテン
保証人	ホショウニン
保証	ホショウ
丸井	マルイ
大区小区制	ダイクショウクセイ
合議制	ゴウギセイ
御殿場市	ゴテンバシ
潤滑	ジュンカツ
あいの里公園駅	アイノサトコウエンエキ
拓北駅	タクホクエキ
甘味料	カンミリョウ
除細動	ジョサイドウ
入生田駅	イリウダエキ
軸受合金	ジクウケゴウキン
近視	キンシ
川西能勢口駅	カワニシノセグチエキ
日生中央駅	ニッセイチュウオウエキ
南足柄市	ミナミアシガラシ
勲章	クンショウ
山陽百貨店	サンヨウヒャッカテン
奄美空港	アマミクウコウ
隕石	インセキ
大河原町	オオガワラマチ
天正	テンショウ
西安事件	セイアンジケン
鉄道擬人化	テツドウギジンカ
擬人観	ギジンカン
擬人化	ギジンカ
関連病院	カンレンビョウイン
種実類	シュジツルイ
馬込沢駅	マゴメザワエキ
渋谷	シブヤ
市町村	シチョウソン
写真集	シャシンシュウ
新宿	シンジュク
無停電電源装置	ムテイデンデンゲンソウチ
日ノ出駅	ヒノデエキ
東区役所前駅	ヒガシクヤクショマエエキ
福住駅	フクズミエキ
包茎	ホウケイ
凝固	ギョウコ
誘起効果	ユウキコウカ
東大宮駅	ヒガシオオミヤエキ
脱離反応	ダツリハンノウ
溶液	ヨウエキ
比較音楽学	ヒカクオンガクガク
中全音律	チュウゼンオンリツ
民間放送	ミンカンホウソウ
一物全体	イチブツゼンタイ
花粉	カフン
弦楽四重奏曲	ゲンガクシジュウソウキョク
碁石	ゴイシ
春秋五覇	シュンジュウゴハ
神宮暦	ジングウレキ
大暦	ダイレキ
お化け暦	オバケゴヨミ
電気伝導体	デンキデンドウタイ
教皇首位説	キョウコウシュイセツ
梅田	ウメダ
叙階	ジョカイ
市制	シセイ
飛田給駅	トビタキュウエキ
江差線	エサシセン
乳飲料	ニュウインリョウ
津軽線	ツガルセン
上野恩賜公園	ウエノオンシコウエン
注意報	チュウイホウ
青函航路	セイカンコウロ
管弦楽法	カンゲンガクホウ
立憲君主派	リッケンクンシュハ
王党派	オウトウハ
三部会	サンブカイ
聖餐論	セイサンロン
対流圏	タイリュウケン
中間圏	チュウカンケン
囚人	シュウジン
宣明暦	センミョウレキ
魔剣	マケン
位格	イカク
王子神谷駅	オウジカミヤエキ
大晦日	オオミソカ
志茂駅	シモエキ
除夜の鐘	ジョヤノカネ
除夜	ジョヤ
風速	フウソク
闇金融	ヤミキンユウ
武富士	タケフジ
魔法陣	マホウジン
上昇気流	ジョウショウキリュウ
下降気流	カコウキリュウ
尾竹橋通り	オタケバシドオリ
大鯰	オオナマズ
明治通り	メイジドオリ
宮島航路	ミヤジマコウロ
形而上学	ケイジジョウガク
湘南台駅	ショウナンダイエキ
吹奏楽	スイソウガク
日置郡	ヒオキグン
都道府県庁所在地	トドウフケンチョウショザイチ
大和三山	ヤマトサンザン
神武天皇即位紀元	ジンムテンノウソクイキゲン
御成門駅	オナリモンエキ
太閤検地	タイコウケンチ
軍隊	グンタイ
自衛隊用語	ジエイタイヨウゴ
早期警戒機	ソウキケイカイキ
公差	コウサ
数列	スウレツ
投了	トウリョウ
あいの里教育大駅	アイノサトキョウイクダイエキ
西友	セイユウ
台場	ダイバ
東京武道館	トウキョウブドウカン
舎人公園	トネリコウエン
東綾瀬公園	ヒガシアヤセコウエン
新河岸駅	シンガシエキ
つきのわ駅	ツキノワエキ
紀伊國屋書店	キノクニヤショテン
貞享暦	ジョウキョウレキ
宝暦暦	ホウリャクレキ
赤飯	セキハン
聖霊派	セイレイハ
消滅した郡の一覧	ショウメツシタグンノイチラン
生理食塩水	セイリショクエンスイ
食虫類	ショクチュウルイ
三輪山	ミワヤマ
利己的遺伝子	リコテキイデンシ
合奏	ガッソウ
重奏	ジュウソウ
名誉勲章	メイヨクンショウ
碁盤	ゴバン
遊廓	ユウカク
南平岸駅	ミナミヒラギシエキ
甲状腺	コウジョウセン
歯	ハ
川口駅	カワグチエキ
典礼	テンレイ
西川口駅	ニシカワグチエキ
蕨駅	ワラビエキ
金町駅	カナマチエキ
南浦和駅	ミナミウラワエキ
聖名祝日	セイメイシュクジツ
宝塚音楽学校	タカラヅカオンガクガッコウ
都	ト
甲賀郡	コウカグン
高等専門学校	コウトウセンモンガッコウ
兵法書	ヘイホウショ
寛政暦	カンセイレキ
西調布駅	ニシチョウフエキ
与野駅	ヨノエキ
戸越駅	トゴシエキ
北浦和駅	キタウラワエキ
浦和駅	ウラワエキ
向原停留場	ムコウハラテイリュウジョウ
東池袋駅	ヒガシイケブクロエキ
屋島	ヤシマ
保存食	ホゾンショク
読売新聞社	ヨミウリシンブンシャ
東池袋四丁目停留場	ヒガシイケブクロヨンチョウメテイリュウジョウ
富雄駅	トミオエキ
日本の呼出符号	ニホンノヨビダシフゴウ
老中	ロウジュウ
電車特定区間	デンシャトクテイクカン
日立製作所	ヒタチセイサクショ
若年寄	ワカドシヨリ
おかざき世界子ども美術博物館	オカザキセカイコドモビジュツハクブツカン
揖斐川	イビガワ
御家人	ゴケニン
清水銀行	シミズギンコウ
小岩駅	コイワエキ
京成小岩駅	ケイセイコイワエキ
実籾駅	ミモミエキ
冷凍工学	レイトウコウガク
土浦駅	ツチウラエキ
二宮駅	ニノミヤエキ
定常状態	テイジョウジョウタイ
潜熱	センネツ
南茨木駅	ミナミイバラキエキ
正雀駅	ショウジャクエキ
持株会社	モチカブガイシャ
斎藤氏	サイトウシ
石山本願寺	イシヤマホンガンジ
静岡銀行	シズオカギンコウ
姉川の戦い	アネガワノタタカイ
紋章	モンショウ
岐阜城	ギフジョウ
御節料理	オセチリョウリ
朝倉氏	アサクラシ
共同通信社	キョウドウツウシンシャ
千代川	センダイガワ
日野川	ヒノガワ
安土城	アヅチジョウ
覆面算	フクメンザン
吉井川	ヨシイガワ
高梁川	タカハシガワ
天神川	テンジンガワ
毛利氏	モウリシ
尼崎市	アマガサキシ
いかなご醤油	イカナゴショウユ
武田氏	タケダシ
足軽	アシガル
下町	シタマチ
山の手	ヤマノテ
歩数計	ホスウケイ
七光台駅	ナナコウダイエキ
清水公園駅	シミズコウエンエキ
川間駅	カワマエキ
野田市駅	ノダシエキ
梅郷駅	ウメサトエキ
藤の牛島駅	フジノウシジマエキ
北大社信号場	キタオオヤシロシンゴウジョウ
尼崎駅	アマガサキエキ
千日手	センニチテ
天満橋駅	テンマバシエキ
今宮戎駅	イマミヤエビスエキ
観応の擾乱	カンノウノジョウラン
萩ノ茶屋駅	ハギノチャヤエキ
天下茶屋駅	テンガチャヤエキ
木曽三川	キソサンセン
岸里玉出駅	キシノサトタマデエキ
守口市駅	モリグチシエキ
溶媒	ヨウバイ
溶解度	ヨウカイド
北上尾駅	キタアゲオエキ
丞相	ジョウショウ
粉浜駅	コハマエキ
住吉大社駅	スミヨシタイシャエキ
住ノ江駅	スミノエエキ
七道駅	シチドウエキ
堺駅	サカイエキ
湊駅	ミナトエキ
石津川駅	イシヅガワエキ
諏訪ノ森駅	スワノモリエキ
羽衣駅	ハゴロモエキ
銀河帝国	ギンガテイコク
伽羅橋駅	キャラバシエキ
高石駅	タカイシエキ
北助松駅	キタスケマツエキ
松ノ浜駅	マツノハマエキ
泉大津駅	イズミオオツエキ
忠岡駅	タダオカエキ
春木駅	ハルキエキ
和泉大宮駅	イズミオオミヤエキ
岸和田駅	キシワダエキ
蛸地蔵駅	タコジゾウエキ
二色浜駅	ニシキノハマエキ
鶴原駅	ツルハラエキ
井原里駅	イハラノサトエキ
泉佐野駅	イズミサノエキ
便所	ベンジョ
関西空港駅	カンサイクウコウエキ
根室本線	ネムロホンセン
塩尻市	シオジリシ
飯山市	イイヤマシ
浦和美園駅	ウラワミソノエキ
鳩ヶ谷市	ハトガヤシ
世界地図	セカイチズ
桶川市	オケガワシ
宿毛市	スクモシ
八月革命説	ハチガツカクメイセツ
表面積	ヒョウメンセキ
搬送波	ハンソウハ
横手市	ヨコテシ
大曲市	オオマガリシ
姉妹社	シマイシャ
天竺	テンジク
国防委員会	コクボウイインカイ
資本減少	シホンゲンショウ
山上の垂訓	サンジョウノスイクン
高野豆腐	コウヤドウフ
単子葉植物	タンシヨウショクブツ
東花園駅	ヒガシハナゾノエキ
市川市	イチカワシ
四字熟語	ヨジジュクゴ
羽倉崎駅	ハグラザキエキ
吉見ノ里駅	ヨシミノサトエキ
岡田浦駅	オカダウラエキ
樽井駅	タルイエキ
富良野線	フラノセン
窪川駅	クボカワエキ
小湊鉄道線	コミナトテツドウセン
位置	イチ
一般相対性原理	イッパンソウタイセイゲンリ
等価原理	トウカゲンリ
作用	サヨウ
逆2乗の法則	ギャクニジョウノホウソク
量子宇宙論	リョウシウチュウロン
回転寿司	カイテンズシ
湖山池	コヤマイケ
十三湖	ジュウサンコ
創価教育学会	ソウカキョウイクガッカイ
円周	エンシュウ
微細構造定数	ビサイコウゾウテイスウ
浦安市	ウラヤスシ
時空連続体	ジクウレンゾクタイ
粒子	リュウシ
球	キュウ
昭烈帝	ショウレツテイ
回天	カイテン
宇宙定数	ウチュウテイスウ
相対論的力学	ソウタイロンテキリキガク
偵察衛星	テイサツエイセイ
木曽川町	キソガワチョウ
顓頊	センギョク
あざみ野駅	アザミノエキ
青葉台駅	アオバダイエキ
中央林間駅	チュウオウリンカンエキ
横浜銀行	ヨコハマギンコウ
平和運動	ヘイワウンドウ
日本棋院	ニホンキイン
二子玉川駅	フタコタマガワエキ
新宿御苑	シンジュクギョエン
正引き	セイヒキ
神泉駅	シンセンエキ
三軒茶屋駅	サンゲンヂャヤエキ
死活	シカツ
氷川台駅	ヒカワダイエキ
江古田駅	エコダエキ
鷺沼駅	サギヌマエキ
名古屋大学駅	ナゴヤダイガクエキ
自由ヶ丘駅	ジユウガオカエキ
茶屋ヶ坂駅	チャヤガサカエキ
砂田橋駅	スナダバシエキ
大曽根駅	オオゾネエキ
西高蔵駅	ニシタカクラエキ
熱田神宮西駅	アツタジングウニシエキ
熱田神宮伝馬町駅	アツタジングウテンマチョウエキ
妙音通駅	ミョウオンドオリエキ
上社駅	カミヤシロエキ
一社駅	イッシャエキ
覚王山駅	カクオウザンエキ
池下駅	イケシタエキ
千種駅	チクサエキ
亀島駅	カメジマエキ
本陣駅	ホンジンエキ
中村公園駅	ナカムラコウエンエキ
八田駅	ハッタエキ
高畑駅	タカバタエキ
野並駅	ノナミエキ
鶴里駅	ツルサトエキ
桜本町駅	サクラホンマチエキ
瑞穂区役所駅	ミズホクヤクショエキ
桜山駅	サクラヤマエキ
御器所駅	ゴキソエキ
久屋大通駅	ヒサヤオオドオリエキ
丸の内駅	マルノウチエキ
太閤通駅	タイコウドオリエキ
上小田井駅	カミオタイエキ
本庄駅	ホンジョウエキ
新栄町駅	シンサカエマチエキ
堀田駅	ホリタエキ
聖教新聞社	セイキョウシンブンシャ
名詞	メイシ
東山区	ヒガシヤマク
動詞	ドウシ
三宮駅	サンノミヤエキ
日本民主党	ニホンミンシュトウ
社格	シャカク
大腸	ダイチョウ
氷雪気候	ヒョウセツキコウ
叢書	ソウショ
日本の白砂青松100選	ニホンノハクシャセイショウヒャクセン
妙見口駅	ミョウケングチエキ
参与観察	サンヨカンサツ
牛久駅	ウシクエキ
系図	ケイズ
三民主義	サンミンシュギ
四条畷駅	シジョウナワテエキ
大口駅	オオグチエキ
片倉駅	カタクラエキ
鴨居駅	カモイエキ
函南駅	カンナミエキ
尾崎駅	オザキエキ
鳥取ノ荘駅	トットリノショウエキ
箱作駅	ハコツクリエキ
淡輪駅	タンノワエキ
秋田市	アキタシ
みさき公園駅	ミサキコウエンエキ
五城目町	ゴジョウメマチ
孝子駅	キョウシエキ
紀ノ川駅	キノカワエキ
和歌山市駅	ワカヤマシエキ
久保町駅	クボチョウエキ
築地橋駅	ツキジバシエキ
築港町駅	チッコウチョウエキ
和歌山港駅	ワカヤマコウエキ
深日町駅	フケチョウエキ
深日港駅	フケコウエキ
多奈川駅	タナガワエキ
中松江駅	ナカマツエエキ
西ノ庄駅	ニシノショウエキ
二里ヶ浜駅	ニリガハマエキ
磯ノ浦駅	イソノウラエキ
食べれません	タベレマセン
三浦郡	ミウラグン
愛甲郡	アイコウグン
高座郡	コウザグン
中郡	ナカグン
足柄上郡	アシガラカミグン
足柄下郡	アシガラシモグン
津久井郡	ツクイグン
大根役者	ダイコンヤクシャ
代名詞	ダイメイシ
連体詞	レンタイシ
陶芸家	トウゲイカ
南秋田郡	ミナミアキタグン
山本郡	ヤマモトグン
北秋田郡	キタアキタグン
鹿角郡	カヅノグン
由利郡	ユリグン
仙北郡	センボクグン
平鹿郡	ヒラカグン
形容詞	ケイヨウシ
雄勝郡	オガチグン
中水道	チュウスイドウ
射石砲	シャセキホウ
青銅砲	セイドウホウ
工業用水道	コウギョウヨウスイドウ
業態	ギョウタイ
宅地開発税	タクチカイハツゼイ
重い電子系	オモイデンシケイ
刺胞動物	シホウドウブツ
海面上昇	カイメンジョウショウ
新岐阜駅前駅	シンギフエキマエエキ
尺八	シャクハチ
大老	タイロウ
町奉行	マチブギョウ
超空洞	チョウクウドウ
勘定奉行	カンジョウブギョウ
三曲合奏	サンキョクガッソウ
浄瑠璃	ジョウルリ
虚無僧	コムソウ
黄道傾斜角	コウドウケイシャカク
熱力学第三法則	ネツリキガクダイサンホウソク
裸の特異点	ハダカノトクイテン
形容動詞	ケイヨウドウシ
揚力	ヨウリョク
接続詞	セツゾクシ
中華鍋	チュウカナベ
日本刀	ニホントウ
田奈駅	タナエキ
市が尾駅	イチガオエキ
可児市	カニシ
碧南市	ヘキナンシ
宮崎台駅	ミヤザキダイエキ
梶が谷駅	カジガヤエキ
つきみ野駅	ツキミノエキ
すずかけ台駅	スズカケダイエキ
つくし野駅	ツクシノエキ
宮前平駅	ミヤマエダイラエキ
二子新地駅	フタコシンチエキ
用賀駅	ヨウガエキ
桜新町駅	サクラシンマチエキ
駒沢大学駅	コマザワダイガクエキ
池尻大橋駅	イケジリオオハシエキ
列聖	レッセイ
常磐津節	トキワヅブシ
関帝	カンテイ
蒲田駅	カマタエキ
播磨町	ハリマチョウ
辻堂駅	ツジドウエキ
茅ケ崎駅	チガサキエキ
平塚駅	ヒラツカエキ
大館市	オオダテシ
大磯駅	オオイソエキ
鹿角市	カヅノシ
本荘市	ホンジョウシ
男鹿市	オガシ
湯沢市	ユザワシ
都筑区	ツヅキク
枚方市駅	ヒラカタシエキ
野間駅	ノマエキ
岩田屋	イワタヤ
汐見橋駅	シオミバシエキ
芦原町駅	アシハラチョウエキ
木津川駅	キヅガワエキ
津守駅	ツモリエキ
西天下茶屋駅	ニシテンガチャヤエキ
帝塚山駅	テヅカヤマエキ
新神戸駅	シンコウベエキ
仁	ジン
住吉東駅	スミヨシヒガシエキ
堺東駅	サカイヒガシエキ
中百舌鳥駅	ナカモズエキ
井筒屋	イヅツヤ
河内長野駅	カワチナガノエキ
西明石駅	ニシアカシエキ
林間田園都市駅	リンカンデンエントシエキ
新年宴会	シンネンエンカイ
極楽橋駅	ゴクラクバシエキ
厚木駅	アツギエキ
京急長沢駅	ケイキュウナガサワエキ
中原区	ナカハラク
西国立駅	ニシクニタチエキ
皿うどん	サラウドン
雪女	ユキオンナ
卓袱料理	シッポクリョウリ
歯車	ハグルマ
巣鴨拘置所	スガモコウチジョ
小堀流踏水術	コボリリュウトウスイジュツ
例外処理	レイガイショリ
釣り糸	ツリイト
練り餌	ネリエ
まき餌	マキエ
釣り竿	ツリザオ
霧社事件	ムシャジケン
統一	トウイツ
産業経済新聞社	サンギョウケイザイシンブンシャ
比内町	ヒナイマチ
上小阿仁村	カミコアニムラ
護国寺駅	ゴコクジエキ
江戸川橋駅	エドガワバシエキ
川西池田駅	カワニシイケダエキ
飯能駅	ハンノウエキ
琴丘町	コトオカマチ
二ツ井町	フタツイマチ
八森町	ハチモリマチ
八竜町	ハチリュウマチ
峰浜村	ミネハマムラ
八郎潟町	ハチロウガタマチ
井川町	イカワマチ
文庫本	ブンコボン
積乱雲	セキランウン
吾野駅	アガノエキ
天王町駅	テンノウチョウエキ
大潟村	オオガタムラ
河辺町	カワベマチ
仁賀保町	ニカホマチ
金浦町	コノウラマチ
帷子川	カタビラガワ
象潟町	キサカタマチ
岩城町	イワキマチ
御門台駅	ミカドダイエキ
元加治駅	モトカジエキ
梁漁	ヤナリョウ
浜名郡	ハマナグン
桑名郡	クワナグン
三重郡	ミエグン
鈴鹿郡	スズカグン
久世郡	クセグン
国道駅	コクドウエキ
甲子園駅	コウシエンエキ
芦屋駅	アシヤエキ
東葛飾郡	ヒガシカツシカグン
弘司	コウジ
魚崎駅	ウオザキエキ
猿島郡	サシマグン
新開地駅	シンカイチエキ
仏子駅	ブシエキ
秋津駅	アキツエキ
小手指駅	コテサシエキ
西代駅	ニシダイエキ
宮前区	ミヤマエク
高津区	タカツク
鳥海町	チョウカイマチ
下都賀郡	シモツガグン
河内郡	カワチグン
塩谷郡	シオヤグン
那須郡	ナスグン
西白河郡	ニシシラカワグン
岩瀬郡	イワセグン
安達郡	アダチグン
伊達郡	ダテグン
刈田郡	カッタグン
柴田郡	シバタグン
黒川郡	クロカワグン
志田郡	シダグン
沖縄市	オキナワシ
栗原郡	クリハラグン
西磐井郡	ニシイワイグン
胆沢郡	イサワグン
稗貫郡	ヒエヌキグン
紫波郡	シワグン
岩手郡	イワテグン
二戸郡	ニノヘグン
三戸郡	サンノヘグン
上北郡	カミキタグン
東津軽郡	ヒガシツガルグン
共在説	キョウザイセツ
元嘉暦	ゲンカレキ
象徴説	ショウチョウセツ
具注暦	グチュウレキ
鶴見駅	ツルミエキ
北陸方言	ホクリクホウゲン
調布市	チョウフシ
豊中駅	トヨナカエキ
岡町駅	オカマチエキ
服部天神駅	ハットリテンジンエキ
十三駅	ジュウソウエキ
管領	カンレイ
春日野道駅	カスガノミチエキ
平安通駅	ヘイアンドオリエキ
添上郡	ソエカミグン
美少女	ビショウジョ
土気駅	トケエキ
守護大名	シュゴダイミョウ
佐久平駅	サクダイラエキ
下克上	ゲコクジョウ
永田町駅	ナガタチョウエキ
桜田門駅	サクラダモンエキ
新富町駅	シントミチョウエキ
西仙北町	ニシセンボクマチ
後楽園駅	コウラクエンエキ
角館町	カクノダテマチ
理科	リカ
阿山郡	アヤマグン
茗荷谷駅	ミョウガダニエキ
戦国七雄	センゴクシチユウ
小山駅	オヤマエキ
新百合ヶ丘駅	シンユリガオカエキ
本厚木駅	ホンアツギエキ
五月台駅	サツキダイエキ
栗平駅	クリヒラエキ
京王堀之内駅	ケイオウホリノウチエキ
原生生物	ゲンセイセイブツ
高砂義勇隊	タカサゴギユウタイ
稲城駅	イナギエキ
京王多摩川駅	ケイオウタマガワエキ
多摩市	タマシ
多摩区	タマク
稲田堤駅	イナダヅツミエキ
元素の系統名	ゲンソノケイトウメイ
夷隅郡	イスミグン
安房郡	アワグン
飯山線	イイヤマセン
夕立	ユウダチ
南会津郡	ミナミアイヅグン
耶麻郡	ヤマグン
北会津郡	キタアイヅグン
卯酉線	ボウユウセン
六分儀	ロクブンギ
淡路駅	アワジエキ
天神橋筋六丁目駅	テンジンバシスジロクチョウメエキ
分裂酵母	ブンレツコウボ
還元算	カンゲンザン
官能小説	カンノウショウセツ
科学館	カガクカン
豊川市	トヨカワシ
伊丹駅	イタミエキ
肥前鹿島駅	ヒゼンカシマエキ
商品	ショウヒン
天体一覧	テンタイイチラン
診療情報提供書	シンリョウジョウホウテイキョウショ
共犯	キョウハン
歓楽街	カンラクガイ
熱的死	ネッテキシ
街	マチ
北伊丹駅	キタイタミエキ
塚口駅	ツカグチエキ
宝町駅	タカラチョウエキ
総合的な学習の時間	ソウゴウテキナガクシュウノジカン
南設楽郡	ミナミシタラグン
渥美郡	アツミグン
富士宮市	フジノミヤシ
保育士	ホイクシ
精霊流し	ショウロウナガシ
日光二荒山神社	ニッコウフタラサンジンジャ
六浦駅	ムツウラエキ
追浜駅	オッパマエキ
抗力	コウリョク
大和市	ヤマトシ
南林間駅	ミナミリンカンエキ
信越地方	シンエツチホウ
菊池郡	キクチグン
西牟婁郡	ニシムログン
東牟婁郡	ヒガシムログン
生駒郡	イコマグン
吉野郡	ヨシノグン
浦佐駅	ウラサエキ
南外村	ナンガイムラ
仙北町	センボクマチ
西木村	ニシキムラ
千畑町	センハタマチ
仙南村	センナンムラ
平鹿町	ヒラカマチ
雄物川町	オモノガワマチ
十文字町	ジュウモンジマチ
稲川町	イナカワマチ
裏金	ウラガネ
羽後町	ウゴマチ
東成瀬村	ヒガシナルセムラ
儀鳳暦	ギホウレキ
神崎川駅	カンザキガワエキ
清荒神清澄寺	キヨシコウジンセイチョウジ
園田駅	ソノダエキ
満洲軍	マンシュウグン
西宮北口駅	ニシノミヤキタグチエキ
北府中駅	キタフチュウエキ
武庫川駅	ムコガワエキ
脂質異常症	シシツイジョウショウ
動脈硬化症	ドウミャクコウカショウ
鷹ノ巣駅	タカノスエキ
糠沢駅	ヌカザワエキ
早口駅	ハヤグチエキ
下川沿駅	シモカワゾイエキ
東能代駅	ヒガシノシロエキ
北金岡駅	キタカナオカエキ
森岳駅	モリタケエキ
朝鮮の君主一覧	チョウセンノクンシュイチラン
月島駅	ツキシマエキ
柴崎駅	シバサキエキ
阿仁前田温泉駅	アニマエダオンセンエキ
下田市	シモダシ
伊勢市	イセシ
鳥羽市	トバシ
鵜殿村	ウドノムラ
新宮市	シングウシ
那智勝浦町	ナチカツウラチョウ
宮津市	ミヤヅシ
福袋	フクブクロ
高砂市	タカサゴシ
倉敷市	クラシキシ
長船町	オサフネチョウ
宮島町	ミヤジマチョウ
太宰府市	ダザイフシ
宗像市	ムナカタシ
宇佐市	ウサシ
中津市	ナカツシ
指宿市	イブスキシ
水俣市	ミナマタシ
球磨村	クマムラ
唐津市	カラツシ
伊万里市	イマリシ
武雄市	タケオシ
紀年法	キネンホウ
前山駅	マエヤマエキ
二ツ井駅	フタツイエキ
富根駅	トミネエキ
四書	シショ
鶴形駅	ツルガタエキ
鹿渡駅	カドエキ
鯉川駅	コイカワエキ
八郎潟駅	ハチロウガタエキ
井川さくら駅	イカワサクラエキ
羽後飯塚駅	ウゴイイヅカエキ
上飯島駅	カミイイジマエキ
土崎駅	ツチザキエキ
四ツ小屋駅	ヨツゴヤエキ
和田駅	ワダエキ
大張野駅	オオバリノエキ
羽後境駅	ウゴサカイエキ
峰吉川駅	ミネヨシカワエキ
憲法裁判所	ケンポウサイバンショ
刈和野駅	カリワノエキ
神宮寺駅	ジングウジエキ
飯詰駅	イイヅメエキ
後三年駅	ゴサンネンエキ
横手駅	ヨコテエキ
柳田駅	ヤナギタエキ
十文字駅	ジュウモンジエキ
下湯沢駅	シモユザワエキ
湯沢駅	ユザワエキ
上湯沢駅	カミユザワエキ
三関駅	ミツセキエキ
横堀駅	ヨコボリエキ
院内駅	インナイエキ
及位駅	ノゾキエキ
北上線	キタカミセン
男鹿線	オガセン
五能線	ゴノウセン
花輪線	ハナワセン
今治市	イマバリシ
小机駅	コヅクエエキ
学校法人	ガッコウホウジン
地動説	チドウセツ
日本海沿岸東北自動車道	ニホンカイエンガントウホクジドウシャドウ
芦屋川駅	アシヤガワエキ
西諸県郡	ニシモロカタグン
城崎郡	キノサキグン
高原町	タカハルチョウ
加古郡	カコグン
青い森鉄道線	アオイモリテツドウセン
多可郡	タカグン
矢美津駅	ヤビツエキ
相野々駅	アイノノエキ
野々市市	ノノイチシ
平石駅	ヒライシエキ
小松川駅	コマツカワエキ
ゆだ高原駅	ユダコウゲンエキ
船井郡	フナイグン
南牟婁郡	ミナミムログン
西元町駅	ニシモトマチエキ
六日町駅	ムイカマチエキ
北佐久郡	キタサクグン
下伊那郡	シモイナグン
南都留郡	ミナミツルグン
藪塚本町	ヤブヅカホンマチ
府中刑務所	フチュウケイムショ
蒲生郡	ガモウグン
性風俗用語一覧	セイフウゾクヨウゴイチラン
東逗子駅	ヒガシズシエキ
保土ケ谷駅	ホドガヤエキ
衣笠駅	キヌガサエキ
久里浜駅	クリハマエキ
出戸浜駅	デトハマエキ
上二田駅	カミフタダエキ
二田駅	フタダエキ
天王駅	テンノウエキ
船越駅	フナコシエキ
脇本駅	ワキモトエキ
羽立駅	ハダチエキ
男鹿駅	オガエキ
北大曲駅	キタオオマガリエキ
羽後四ツ屋駅	ウゴヨツヤエキ
鑓見内駅	ヤリミナイエキ
羽後長野駅	ウゴナガノエキ
鶯野駅	ウグイスノエキ
角館駅	カクノダテエキ
刺巻駅	サシマキエキ
田沢湖駅	タザワコエキ
赤渕駅	アカブチエキ
羽越本線	ウエツホンセン
淀川駅	ヨドガワエキ
姫島駅	ヒメジマエキ
陣場駅	ジンバエキ
津軽湯の沢駅	ツガルユノサワエキ
千船駅	チブネエキ
杭瀬駅	クイセエキ
能代駅	ノシロエキ
向能代駅	ムカイノシロエキ
北能代駅	キタノシロエキ
鳥形駅	トリガタエキ
沢目駅	サワメエキ
東八森駅	ヒガシハチモリエキ
八森駅	ハチモリエキ
大物駅	ダイモツエキ
滝ノ間駅	タキノマエキ
あきた白神駅	アキタシラカミエキ
岩館駅	イワダテエキ
大間越駅	オオマゴシエキ
小砂川駅	コサガワエキ
上浜駅	カミハマエキ
象潟駅	キサカタエキ
金浦駅	コノウラエキ
仁賀保駅	ニカホエキ
西目駅	ニシメエキ
女鹿駅	メガエキ
羽後本荘駅	ウゴホンジョウエキ
出屋敷駅	デヤシキエキ
羽後岩谷駅	ウゴイワヤエキ
折渡駅	オリワタリエキ
羽後亀田駅	ウゴカメダエキ
岩城みなと駅	イワキミナトエキ
道川駅	ミチカワエキ
下浜駅	シモハマエキ
桂根駅	カツラネエキ
羽後牛島駅	ウゴウシジマエキ
東大館駅	ヒガシオオダテエキ
扇田駅	オウギタエキ
大滝温泉駅	オオタキオンセンエキ
十二所駅	ジュウニショエキ
沢尻駅	サワジリエキ
土深井駅	ドブカイエキ
末広駅	スエヒロエキ
十和田南駅	トワダミナミエキ
柴平駅	シバヒラエキ
鹿角花輪駅	カヅノハナワエキ
陸中大里駅	リクチュウオオサトエキ
八幡平駅	ハチマンタイエキ
湯瀬温泉駅	ユゼオンセンエキ
兄畑駅	アニハタエキ
秋田駅	アキタエキ
世界各国関係記事の一覧	セカイカッコクカンケイキジノイチラン
春秋戦国時代	シュンジュウセンゴクジダイ
桂瀬駅	カツラセエキ
上杉駅	カミスギエキ
縄文小ヶ田駅	ジョウモンオガタエキ
西鷹巣駅	ニシタカノスエキ
小渕駅	コブチエキ
阿仁合駅	アニアイエキ
比立内駅	ヒタチナイエキ
規定打席	キテイダセキ
子吉駅	コヨシエキ
最多本塁打	サイタホンルイダ
最多打点	サイタダテン
曲沢駅	マガリサワエキ
前郷駅	マエゴウエキ
西滝沢駅	ニシタキサワエキ
吉沢駅	ヨシザワエキ
川辺駅	カワベエキ
矢島駅	ヤシマエキ
安打	アンダ
最優秀防御率	サイユウシュウボウギョリツ
鮎川駅	アユカワエキ
久我山駅	クガヤマエキ
雫石駅	シズクイシエキ
春木場駅	ハルキバエキ
小岩井駅	コイワイエキ
大釜駅	オオカマエキ
犠打	ギダ
大館駅	オオダテエキ
四死球	シシキュウ
死球	シキュウ
祭服	サイフク
托鉢修道会	タクハツシュウドウカイ
四ツ倉駅	ヨツクラエキ
田山駅	タヤマエキ
横間駅	ヨコマエキ
荒屋新町駅	アラヤシンマチエキ
小屋の畑駅	コヤノハタエキ
赤坂田駅	アカサカタエキ
安比高原駅	アッピコウゲンエキ
松尾八幡平駅	マツオハチマンタイエキ
北森駅	キタモリエキ
平館駅	タイラダテエキ
大更駅	オオブケエキ
東大更駅	ヒガシオオブケエキ
厨川駅	クリヤガワエキ
滝沢駅	タキザワエキ
渋民駅	シブタミエキ
岩手川口駅	イワテカワグチエキ
いわて沼宮内駅	イワテヌマクナイエキ
御堂駅	ミドウエキ
奥中山高原駅	オクナカヤマコウゲンエキ
小繋駅	コツナギエキ
小鳥谷駅	コズヤエキ
一戸駅	イチノヘエキ
二戸駅	ニノヘエキ
斗米駅	トマイエキ
金田一温泉駅	キンタイチオンセンエキ
目時駅	メトキエキ
三戸駅	サンノヘエキ
諏訪ノ平駅	スワノタイラエキ
剣吉駅	ケンヨシエキ
苫米地駅	トマベチエキ
北高岩駅	キタタカイワエキ
好摩駅	コウマエキ
仙北町駅	センボクチョウエキ
岩手飯岡駅	イワテイイオカエキ
矢幅駅	ヤハバエキ
古館駅	フルダテエキ
紫波中央駅	シワチュウオウエキ
日詰駅	ヒヅメエキ
石鳥谷駅	イシドリヤエキ
花巻空港駅	ハナマキクウコウエキ
村崎野駅	ムラサキノエキ
北上駅	キタカミエキ
六原駅	ロクハラエキ
金ケ崎駅	カネガサキエキ
水沢駅	ミズサワエキ
陸中折居駅	リクチュウオリイエキ
前沢駅	マエサワエキ
平泉駅	ヒライズミエキ
山ノ目駅	ヤマノメエキ
一ノ関駅	イチノセキエキ
新花巻駅	シンハナマキエキ
水沢江刺駅	ミズサワエサシエキ
吹奏楽団の一覧	スイソウガクダンノイチラン
くりこま高原駅	クリコマコウゲンエキ
古川駅	フルカワエキ
白石蔵王駅	シロイシザオウエキ
新白河駅	シンシラカワエキ
那須塩原駅	ナスシオバラエキ
三ツ境駅	ミツキョウエキ
近郊形車両	キンコウガタシャリョウ
聴取率	チョウシュリツ
出版不況	シュッパンフキョウ
回診	カイシン
侮辱罪	ブジョクザイ
ほっとゆだ駅	ホットユダエキ
ゆだ錦秋湖駅	ユダキンシュウコエキ
和賀仙人駅	ワカセンニンエキ
岩沢駅	イワサワエキ
横川目駅	ヨコカワメエキ
立川目駅	タテカワメエキ
藤根駅	フジネエキ
江釣子駅	エヅリコエキ
長峰駅	ナガミネエキ
大鰐温泉駅	オオワニオンセンエキ
弘前駅	ヒロサキエキ
撫牛子駅	ナイジョウシエキ
碇ケ関駅	イカリガセキエキ
鉄道弘済会	テツドウコウサイカイ
野毛山動物園	ノゲヤマドウブツエン
最多勝利	サイタショウリ
勝利投手	ショウリトウシュ
特定都市鉄道整備積立金	トクテイトシテツドウセイビツミタテキン
文化財	ブンカザイ
三代格式	サンダイキャクシキ
延喜式	エンギシキ
名勝	メイショウ
小郡市	オゴオリシ
不当利得	フトウリトク
木曽川駅	キソガワエキ
雑煮	ゾウニ
屠蘇	オトソ
久寿川駅	クスガワエキ
鹿島市	カシマシ
鳥栖市	トスシ
多久市	タクシ
三養基郡	ミヤキグン
美咲が丘駅	ミサキガオカエキ
弥生が丘駅	ヤヨイガオカエキ
園部駅	ソノベエキ
球磨郡	クマグン
佐伯郡	サエキグン
邑久郡	オクグン
吉城郡	ヨシキグン
大野郡	オオノグン
武儀郡	ムギグン
不破郡	フワグン
天皇陵	テンノウリョウ
虎ノ門駅	トラノモンエキ
内幸町駅	ウチサイワイチョウエキ
彦根市	ヒコネシ
守山市	モリヤマシ
新幹線直行特急	シンカンセンチョッコウトッキュウ
草津市	クサツシ
香櫨園駅	コウロエンエキ
修道院	シュウドウイン
青木駅	オオギエキ
石屋川駅	イシヤガワエキ
北陸先端科学技術大学院大学	ホクリクセンタンカガクギジュツダイガクインダイガク
工芸	コウゲイ
台湾関係記事の一覧	タイワンカンケイキジノイチラン
伊香郡	イカグン
剛性	ゴウセイ
韓国関係記事の一覧	カンコクカンケイキジノイチラン
新庄駅	シンジョウエキ
大石田駅	オオイシダエキ
さくらんぼ東根駅	サクランボヒガシネエキ
天童駅	テンドウエキ
山形駅	ヤマガタエキ
かみのやま温泉駅	カミノヤマオンセンエキ
集札	シュウサツ
赤湯駅	アカユエキ
出札	シュッサツ
高畠駅	タカハタエキ
検札	ケンサツ
米沢駅	ヨネザワエキ
米坂線	ヨネサカセン
左沢線	アテラザワセン
白新線	ハクシンセン
指紋	シモン
越後線	エチゴセン
弥彦線	ヤヒコセン
仙山線	センザンセン
上田駅	ウエダエキ
似内駅	ニタナイエキ
下河原線	シモガワラセン
綾部市	アヤベシ
芝山千代田駅	シバヤマチヨダエキ
京成成田駅	ケイセイナリタエキ
法王	ホウオウ
浦賀駅	ウラガエキ
堀ノ内駅	ホリノウチエキ
金沢八景駅	カナザワハッケイエキ
金沢文庫駅	カナザワブンコエキ
認知	ニンチ
日光東照宮	ニッコウトウショウグウ
常民	ジョウミン
二子玉川園	フタコタマガワエン
指差喚呼	シサカンコ
紀元前18世紀	キゲンゼンジュウハチセイキ
詐欺罪	サギザイ
上表文	ジョウヒョウブン
羽前小松駅	ウゼンコマツエキ
谷津遊園	ヤツユウエン
羽前椿駅	ウゼンツバキエキ
越後下関駅	エチゴシモセキエキ
陸羽東線	リクウトウセン
陸羽西線	リクウサイセン
石巻線	イシノマキセン
大湊線	オオミナトセン
八戸線	ハチノヘセン
活字合金	カツジゴウキン
消費	ショウヒ
水郡線	スイグンセン
最優秀投手	サイユウシュウトウシュ
石炭	セキタン
観測	カンソク
劇場	ゲキジョウ
新在家駅	シンザイケエキ
鳥居本駅	トリイモトエキ
大石駅	オオイシエキ
西灘駅	ニシナダエキ
川部駅	カワベエキ
北常盤駅	キタトキワエキ
浪岡駅	ナミオカエキ
大釈迦駅	ダイシャカエキ
鶴ケ坂駅	ツルガサカエキ
津軽新城駅	ツガルシンジョウエキ
新青森駅	シンアオモリエキ
水戸市	ミトシ
青森駅	アオモリエキ
油川駅	アブラカワエキ
津軽宮田駅	ツガルミヤタエキ
奥内駅	オクナイエキ
左堰駅	ヒダリセキエキ
後潟駅	ウシロガタエキ
中沢駅	ナカサワエキ
蓬田駅	ヨモギタエキ
郷沢駅	ゴウサワエキ
瀬辺地駅	セヘジエキ
蟹田駅	カニタエキ
白神岳登山口駅	シラカミダケトザングチエキ
松神駅	マツカミエキ
十二湖駅	ジュウニコエキ
陸奥岩崎駅	ムツイワサキエキ
陸奥沢辺駅	ムツサワベエキ
艫作駅	ヘナシエキ
横磯駅	ヨコイソエキ
深浦駅	フカウラエキ
広戸駅	ヒロトエキ
追良瀬駅	オイラセエキ
驫木駅	トドロキエキ
風合瀬駅	カソセエキ
大戸瀬駅	オオドセエキ
北金ケ沢駅	キタカネガサワエキ
陸奥柳田駅	ムツヤナギタエキ
陸奥赤石駅	ムツアカイシエキ
鰺ケ沢駅	アジガサワエキ
鳴沢駅	ナルサワエキ
越水駅	コシミズエキ
陸奥森田駅	ムツモリタエキ
木造駅	キヅクリエキ
五所川原駅	ゴショガワラエキ
陸奥鶴田駅	ムツツルダエキ
鶴泊駅	ツルドマリエキ
板柳駅	イタヤナギエキ
林崎駅	ハヤシザキエキ
行田駅	ギョウダエキ
津軽鉄道線	ツガルテツドウセン
西津軽郡	ニシツガルグン
中津軽郡	ナカツガルグン
南津軽郡	ミナミツガルグン
北津軽郡	キタツガルグン
下北郡	シモキタグン
北岳	キタダケ
穂高岳	ホタカダケ
槍ヶ岳	ヤリガタケ
谷川岳	タニガワダケ
大高駅	オオダカエキ
連載小説	レンサイショウセツ
導磁率	ドウジリツ
観察	カンサツ
再生産労働	サイセイサンロウドウ
妙見山駅	ミョウケンサンエキ
桓国	カンコク
怪獣の一覧	カイジュウノイチラン
怪獣	カイジュウ
遺跡	イセキ
角度	カクド
お年玉付郵便はがき	オトシダマツキユウビンハガキ
郵便受け	ユウビンウケ
怪人	カイジン
つくば号	ツクバゴウ
江ノ島駅	エノシマエキ
敗戦投手	ハイセントウシュ
実写	ジッシャ
小海線	コウミセン
肥薩おれんじ鉄道線	ヒサツオレンジテツドウセン
粉末冶金	フンマツヤキン
桓公	カンコウ
生活列車	セイカツレッシャ
近江八幡市	オウミハチマンシ
献体	ケンタイ
適時打	テキジダ
只見線	タダミセン
水戸線	ミトセン
皇民化教育	コウミンカキョウイク
寺格	ジカク
古淵駅	コブチエキ
淵野辺駅	フチノベエキ
上御霊神社	カミゴリョウジンジャ
度	ド
家督	カトク
猿楽	サルガク
足利氏	アシカガシ
細川氏	ホソカワシ
知立市	チリュウシ
公布	コウフ
潜水母艦	センスイボカン
艦載機	カンサイキ
軍艦	グンカン
応報刑論	オウホウケイロン
大阪上本町駅	オオサカウエホンマチエキ
布施駅	フセエキ
石北本線	セキホクホンセン
菜食主義	サイショクシュギ
全体主義体制	ゼンタイシュギタイセイ
末広町駅	スエヒロチョウエキ
食物連鎖	ショクモツレンサ
吾妻線	アガツマセン
松本駅	マツモトエキ
南小谷駅	ミナミオタリエキ
大局将棋	タイキョクショウギ
釧網本線	センモウホンセン
特殊法人	トクシュホウジン
特定疾患	トクテイシッカン
書籍小包	ショセキコヅツミ
大西洋憲章	タイセイヨウケンショウ
文公	ブンコウ
修験道	シュゲンドウ
紋章院	モンショウイン
電気双極子	デンキソウキョクシ
留萌本線	ルモイホンセン
刀剣の業物一覧	トウケンノワザモノイチラン
身分	ミブン
無罪	ムザイ
屋代駅	ヤシロエキ
血液	ケツエキ
羽咋市	ハクイシ
太祖	タイソ
魯	ロ
桜区	サクラク
丹波橋駅	タンババシエキ
嚳	コク
日高本線	ヒダカホンセン
引佐郡	イナサグン
氷見線	ヒミセン
最小作用の原理	サイショウサヨウノゲンリ
城端線	ジョウハナセン
軌道角運動量	キドウカクウンドウリョウ
大滝駅	オオタキエキ
釜淵駅	カマブチエキ
真室川駅	マムロガワエキ
羽前豊里駅	ウゼントヨサトエキ
泉田駅	イズミタエキ
舟形駅	フナガタエキ
芦沢駅	アシサワエキ
北大石田駅	キタオオイシダエキ
袖崎駅	ソデサキエキ
東根駅	ヒガシネエキ
神町駅	ジンマチエキ
乱川駅	ミダレガワエキ
変位	ヘンイ
慣性航法装置	カンセイコウホウソウチ
松山市駅	マツヤマシエキ
高擶駅	タカタマエキ
南出羽駅	ミナミデワエキ
羽前千歳駅	ウゼンチトセエキ
北山形駅	キタヤマガタエキ
蔵王駅	ザオウエキ
茂吉記念館前駅	モキチキネンカンマエエキ
羽前中山駅	ウゼンナカヤマエキ
置賜駅	オイタマエキ
関根駅	セキネエキ
板谷駅	イタヤエキ
庭坂駅	ニワサカエキ
笹木野駅	ササキノエキ
東日本橋駅	ヒガシニホンバシエキ
蔵前駅	クラマエエキ
豊洲駅	トヨスエキ
二十日正月	ハツカショウガツ
仕事始め	シゴトハジメ
姫始め	ヒメハジメ
元日節会	ガンジツノセチエ
拘束具	コウソクグ
手錠	テジョウ
住吉区	スミヨシク
住吉三神	スミヨシサンジン
横行	オウギョウ
国分寺市	コクブンジシ
神仏分離	シンブツブンリ
波動力学	ハドウリキガク
国家神道	コッカシントウ
中性子線	チュウセイシセン
鏡餅	カガミモチ
恵方詣り	エホウマイリ
若水	ワカミズ
別所温泉	ベッショオンセン
関関同立	カンカンドウリツ
産近甲龍	サンキンコウリュウ
断熱過程	ダンネツカテイ
長岡駅	ナガオカエキ
歯学部	シガクブ
北海道医療大学	ホッカイドウイリョウダイガク
亀岡市	カメオカシ
宮城県北部地震	ミヤギケンホクブジシン
城陽市	ジョウヨウシ
三顧の礼	サンコノレイ
世界大百科事典	セカイダイヒャッカジテン
平凡社	ヘイボンシャ
石油精製	セキユセイセイ
戦闘一覧	セントウイチラン
承久の乱	ジョウキュウノラン
北条氏	ホウジョウシ
奔王	ホンオウ
反車	ヘンシャ
守護	シュゴ
盲虎	モウコ
地頭	ジトウ
建武の新政	ケンムノシンセイ
都島区	ミヤコジマク
福島区	フクシマク
此花区	コノハナク
大正区	タイショウク
天王寺区	テンノウジク
浪速区	ナニワク
西淀川区	ニシヨドガワク
環濠集落	カンゴウシュウラク
東淀川区	ヒガシヨドガワク
東成区	ヒガシナリク
生野区	イクノク
七宝町	シッポウチョウ
東住吉区	ヒガシスミヨシク
西成区	ニシナリク
淀川区	ヨドガワク
住之江区	スミノエク
平野区	ヒラノク
開成駅	カイセイエキ
東京六大学	トウキョウロクダイガク
猛豹	モウヒョウ
銅将	ドウショウ
通天閣	ツウテンカク
醉象	スイゾウ
東方美人	トウホウビジン
菱葩餅	ヒシハナビラモチ
八月十八日の政変	ハチガツジュウハチニチノセイヘン
鹿鳴館	ロクメイカン
捜索	ソウサク
濃尾地震	ノウビジシン
陰核包皮	インカクホウヒ
千代田駅	チヨダエキ
鹿児島	カゴシマ
長期欠席	チョウキケッセキ
初売り	ハツウリ
燕三条駅	ツバメサンジョウエキ
遺伝的多様性	イデンテキタヨウセイ
中華まん	チュウカマン
正距方位図法	セイキョホウイズホウ
碧蹄館の戦い	ヘキテイカンノタタカイ
五奉行	ゴブギョウ
第百十国立銀行	ダイヒャクジュウコクリツギンコウ
山城屋事件	ヤマシロヤジケン
学校法人開成学園	ガッコウホウジンカイセイガクエン
元始祭	ゲンシサイ
禅譲	ゼンジョウ
大英博物館	ダイエイハクブツカン
矢	ヤ
武王	ブオウ
連署	レンショ
鹿児島大学	カゴシマダイガク
総合的病害虫管理	ソウゴウテキビョウガイチュウカンリ
日本の大学一覧	ニホンノダイガクイチラン
五賢帝	ゴケンテイ
埼玉大学	サイタマダイガク
和人	ワジン
摩周湖	マシュウコ
倭人	ワジン
点字	テンジ
氣志團	キシダン
湖沼の一覧	コショウノイチラン
口語	コウゴ
脚気	カッケ
和歌山大学	ワカヤマダイガク
註釈学派	チュウシャクガクハ
昭和医科大学	ショウワイカダイガク
台湾出兵	タイワンシュッペイ
原子力潜水艦	ゲンシリョクセンスイカン
書体	ショタイ
放送大学学園	ホウソウダイガクガクエン
全順序	ゼンジュンジョ
小金井市	コガネイシ
小平市	コダイラシ
国立市	クニタチシ
立川市	タチカワシ
三原市	ミハラシ
生物多様性	セイブツタヨウセイ
単為結果	タンイケッカ
濁音	ダクオン
利子	リシ
偶力	グウリョク
乾麺	カンメン
堺事件	サカイジケン
奥津軽いまべつ駅	オクツガルイマベツエキ
富士川	フジカワ
四ツ橋駅	ヨツバシエキ
佐賀の乱	サガノラン
横猿	オウエン
豚将	トンショウ
方行	ホウギョウ
猛鹿	モウロク
山鳩	サンキュウ
長距離秩序	チョウキョリチツジョ
函館市企業局交通部	ハコダテシキギョウキョクコウツウブ
猛龍	モウリュウ
食肉目	ショクニクモク
大鳩	ダイキュウ
三島駅	ミシマエキ
犬の品種一覧	イヌノヒンシュイチラン
草書体	ソウショタイ
伊丹市	イタミシ
築地市場駅	ツキジシジョウエキ
仁方駅	ニガタエキ
伴奏	バンソウ
国民野球連盟	コクミンヤキュウレンメイ
等々力陸上競技場	トドロキリクジョウキョウギジョウ
芝川町	シバカワチョウ
初荷	ハツニ
大石寺	タイセキジ
水龍	スイリュウ
猪兵	チョヘイ
鵬師	ホウシ
秋田空港	アキタクウコウ
恒等式	コウトウシキ
地球外知的生命体探査	チキュウガイチテキセイメイタイタンサ
令外官	リョウゲノカン
大館能代空港	オオダテノシロクウコウ
韓国併合ニ関スル条約	カンコクヘイゴウニカンスルジョウヤク
陰流	カゲリュウ
百物語	ヒャクモノガタリ
新陰流	シンカゲリュウ
第二次日韓協約	ダイニジニッカンキョウヤク
歌詞	カシ
昆虫学	コンチュウガク
歌曲	カキョク
寒	カン
暑中	ショチュウ
法三章	ホウサンショウ
半大統領制	ハンダイトウリョウセイ
加須市	カゾシ
作曲	サッキョク
商品券	ショウヒンケン
新代田駅	シンダイタエキ
東京競馬場前駅	トウキョウケイバジョウマエエキ
日本国有鉄道の荷物運送	ニホンコクユウテツドウノニモツウンソウ
南栗橋駅	ミナミクリハシエキ
覆水盆に返らず	フクスイボンニカエラズ
茨木市	イバラキシ
日用品	ニチヨウヒン
白島駅	ハクシマエキ
急行形車両	キュウコウガタシャリョウ
城北駅	ジョウホクエキ
本通駅	ホンドオリエキ
焚書	フンショ
援助交際	エンジョコウサイ
絶対国防圏	ゼッタイコクボウケン
坑儒	コウジュ
十束剣	トツカノツルギ
主調整室	シュチョウセイシツ
北陸中日新聞	ホクリクチュウニチシンブン
社会人野球日本選手権大会	シャカイジンヤキュウニホンセンシュケンタイカイ
都市対抗	トシタイコウ
昭和基地	ショウワキチ
世界一の一覧	セカイイチノイチラン
御坊駅	ゴボウエキ
環境基準	カンキョウキジュン
出水市	イズミシ
文政	ブンセイ
刀兵	トウヘイ
全国中学校体育大会	ゼンコクチュウガッコウタイイクタイカイ
湿布	シップ
語呂合わせ	ゴロアワセ
猿投駅	サナゲエキ
梅坪駅	ウメツボエキ
豊田市駅	トヨタシエキ
日本の短期大学一覧	ニホンノタンキダイガクイチラン
知立駅	チリュウエキ
宇宙戦艦	ウチュウセンカン
人工天体	ジンコウテンタイ
輸液	ユエキ
日記	ニッキ
深川市	フカガワシ
大志田駅	オオシダエキ
高塚駅	タカツカエキ
乗り継ぎ料金制度	ノリツギリョウキンセイド
右龍	ウリュウ
左龍	サリュウ
小屋浦駅	コヤウラエキ
みずほ基地	ミズホキチ
木将	モクショウ
天応駅	テンノウエキ
変狸	ヘンリ
吉浦駅	ヨシウラエキ
川原石駅	カワライシエキ
かるが浜駅	カルガハマエキ
金鹿	コンロク
安芸川尻駅	アキカワジリエキ
安登駅	アトエキ
安浦駅	ヤスウラエキ
府中町	フチュウチョウ
京都放送	キョウトホウソウ
あすか基地	アスカキチ
新浦安駅	シンウラヤスエキ
宮島連絡船	ミヤジマレンラクセン
情報機関	ジョウホウキカン
白糸台駅	シライトダイエキ
多磨駅	タマエキ
羽子板	ハゴイタ
軍事訓練	グンジクンレン
東脊振村	ヒガシセフリソン
神埼郡	カンザキグン
刈谷駅	カリヤエキ
刈谷市駅	カリヤシエキ
小垣江駅	オガキエエキ
三河高浜駅	ミカワタカハマエキ
高浜港駅	タカハマミナトエキ
碧南中央駅	ヘキナンチュウオウエキ
雲伯方言	ウンパクホウゲン
富士郡	フジグン
新大津駅	シンオオツエキ
宮崎郡	ミヤザキグン
伊予郡	イヨグン
横飛	オウヒ
大鹿	ダイロク
大沼郡	オオヌマグン
銅車	ドウシャ
矢吹町	ヤブキマチ
鐵将	テツショウ
南佐久郡	ミナミサクグン
瓦将	ガショウ
羽前山辺駅	ウゼンヤマベエキ
東金井駅	ヒガシカナイエキ
羽前金沢駅	ウゼンカネザワエキ
有田市	アリダシ
歩行	ホコウ
久留里線	クルリセン
準静的過程	ジュンセイテキカテイ
赤ちゃん	アカチャン
役満貫	ヤクマンガン
東金線	トウガネセン
熊兵	ユウヘイ
空中給油機	クウチュウキュウユキ
電子戦機	デンシセンキ
鬼怒川	キヌガワ
小貝川	コカイガワ
新川町停留場	シンカワチョウテイリュウジョウ
日本の神の一覧	ニホンノカミノイチラン
本郷台駅	ホンゴウダイエキ
上山競馬場	カミノヤマケイバジョウ
栄区	サカエク
兵庫県競馬組合	ヒョウゴケンケイバクミアイ
港南台駅	コウナンダイエキ
洋光台駅	ヨウコウダイエキ
東白川郡	ヒガシシラカワグン
是政駅	コレマサエキ
石川郡	イシカワグン
田村郡	タムラグン
双葉郡	フタバグン
相馬郡	ソウマグン
河沼郡	カワヌマグン
東部市場前駅	トウブシジョウマエエキ
基礎	キソ
新小金井駅	シンコガネイエキ
山辺町	ヤマノベマチ
医科大学	イカダイガク
熊野本宮大社	クマノホングウタイシャ
熊野速玉大社	クマノハヤタマタイシャ
熊野三山	クマノサンザン
医師賠償責任保険	イシバイショウセキニンホケン
熊野那智大社	クマノナチタイシャ
成瀬駅	ナルセエキ
矢部駅	ヤベエキ
狩人	カリュウド
二十二社	ニジュウニシャ
一味唐辛子	イチミトウガラシ
掛川駅	カケガワエキ
空振り	カラブリ
槍	ヤリ
橋本市	ハシモトシ
東京十社	トウキョウジッシャ
勅祭社	チョクサイシャ
軍用車両	グンヨウシャリョウ
雨仕舞	アマジマイ
弾性率	ダンセイリツ
特殊部隊	トクシュブタイ
肥厚性瘢痕	ヒコウセイハンコン
芦ヶ久保駅	アシガクボエキ
女衒	ゼゲン
輸送艦	ユソウカン
乱流	ランリュウ
杉本町駅	スギモトチョウエキ
日時計	ヒドケイ
賤ヶ岳の戦い	シズガタケノタタカイ
特急形車両	トッキュウガタシャリョウ
合番	アイバン
西日本新聞	ニシニッポンシンブン
財部町	タカラベチョウ
北海道新聞	ホッカイドウシンブン
河北新報	カホクシンポウ
稲沢市	イナザワシ
棍棒	コンボウ
作詞家	サクシカ
三節棍	サンセツコン
脱穀	ダッコク
上尾駅	アゲオエキ
花見川区	ハナミガワク
環境問題関連の記事一覧	カンキョウモンダイカンレンノキジイチラン
新安城駅	シンアンジョウエキ
反訴	ハンソ
学芸大学駅	ガクゲイダイガクエキ
美浜区	ミハマク
西彼町	セイヒチョウ
雪国	ユキグニ
宇高連絡船	ウコウレンラクセン
道後温泉駅	ドウゴオンセンエキ
池谷駅	イケノタニエキ
愛知工業大学	アイチコウギョウダイガク
垂直帰線区間	スイチョクキセンクカン
福岡放送	フクオカホウソウ
綱島駅	ツナシマエキ
代官山駅	ダイカンヤマエキ
海岸工学	カイガンコウガク
新丸子駅	シンマルコエキ
連邦管区	レンポウカンク
白楽駅	ハクラクエキ
東白楽駅	ヒガシハクラクエキ
反町駅	タンマチエキ
標茶駅	シベチャエキ
高島町駅	タカシマチョウエキ
茅沼駅	カヤヌマエキ
北加賀屋駅	キタカガヤエキ
黒体放射	コクタイホウシャ
摩周駅	マシュウエキ
塘路駅	トウロエキ
標茶町	シベチャチョウ
川上郡	カワカミグン
文化勲章	ブンカクンショウ
中国文学	チュウゴクブンガク
吸血鬼	キュウケツキ
大阪商大事件	オオサカショウダイジケン
東林間駅	ヒガシリンカンエキ
東大和市	ヒガシヤマトシ
松前線	マツマエセン
斜面崩壊	シャメンホウカイ
環境問題	カンキョウモンダイ
幸区	サイワイク
逗子市	ズシシ
鹿島田駅	カシマダエキ
京急久里浜駅	ケイキュウクリハマエキ
航空会社	コウクウガイシャ
少年画報社	ショウネンガホウシャ
神戸らんぷ亭	コウベランプテイ
水面波	スイメンハ
錦帯橋	キンタイキョウ
有田郡	アリダグン
曽於郡	ソオグン
西彼杵郡	ニシソノギグン
醸造酒	ジョウゾウシュ
東村山郡	ヒガシムラヤマグン
樽廻船	タルカイセン
膳所本町駅	ゼゼホンマチエキ
上毛高原駅	ジョウモウコウゲンエキ
高崎駅	タカサキエキ
本庄早稲田駅	ホンジョウワセダエキ
静岡駅	シズオカエキ
岐阜羽島駅	ギフハシマエキ
天王寺動物園	テンノウジドウブツエン
引数	ヒキスウ
古学	コガク
乙巳の変	イッシノヘン
法定刑	ホウテイケイ
風早駅	カザハヤエキ
安芸津駅	アキツエキ
吉名駅	ヨシナエキ
竹原駅	タケハラエキ
大乗駅	オオノリエキ
安芸長浜駅	アキナガハマエキ
忠海駅	タダノウミエキ
安芸幸崎駅	アキサイザキエキ
須波駅	スナミエキ
亡命	ボウメイ
お蔭参り	オカゲマイリ
格変化	カクヘンカ
武蔵嵐山駅	ムサシランザンエキ
交代寄合	コウタイヨリアイ
文芸評論	ブンゲイヒョウロン
石清水八幡宮	イワシミズハチマングウ
下曽我駅	シモソガエキ
放射	ホウシャ
国語辞典	コクゴジテン
梅津寺駅	バイシンジエキ
名電山中駅	メイデンヤマナカエキ
信号場	シンゴウジョウ
東岡崎駅	ヒガシオカザキエキ
神戸新聞社	コウベシンブンシャ
市原市	イチハラシ
口之島牛	クチノシマウシ
皇大神宮	コウタイジングウ
川湯温泉駅	カワユオンセンエキ
半導体工学	ハンドウタイコウガク
釧路駅	クシロエキ
東釧路駅	ヒガシクシロエキ
釧路町	クシロチョウ
横龍	オウリュウ
鳫飛	ガンヒ
幌内線	ホロナイセン
羽村駅	ハムラエキ
河辺駅	カベエキ
石垣市	イシガキシ
平良市	ヒララシ
竹富町	タケトミチョウ
西表島	イリオモテジマ
歌志内線	ウタシナイセン
西八王子駅	ニシハチオウジエキ
北八王子駅	キタハチオウジエキ
小宮駅	コミヤエキ
東福生駅	ヒガシフッサエキ
箱根ケ崎駅	ハコネガサキエキ
金子駅	カネコエキ
拝島駅	ハイジマエキ
葛飾区	カツシカク
鶴橋駅	ツルハシエキ
小三元	ショウサンゲン
津幡駅	ツバタエキ
五紀暦	ゴキレキ
佐久町	サクマチ
大衍暦	タイエンレキ
社員食堂	シャインショクドウ
松戸駅	マツドエキ
秦野駅	ハダノエキ
身分犯	ミブンハン
ひたちなか市	ヒタチナカシ
かつた祭り	カツタマツリ
今里駅	イマザトエキ
設計	セッケイ
富沢駅	トミザワエキ
長町南駅	ナガマチミナミエキ
門真市	カドマシ
阿寒町	アカンチョウ
精神医学	セイシンイガク
東所沢駅	ヒガシトコロザワエキ
地形輪廻	チケイリンネ
愛子駅	アヤシエキ
保険	ホケン
北仙台駅	キタセンダイエキ
味噌田楽	ミソデンガク
酒呑童子	シュテンドウジ
服飾学校	フクショクガッコウ
潮来市	イタコシ
雨龍	ウリュウ
牛将	ギュウショウ
幡ヶ谷駅	ハタガヤエキ
磐田市	イワタシ
責任払い	セキニンバライ
鳩槃	キュウハン
竪狼	シュロウ
銀兎	ギント
登猿	トウエン
鳩盤	キュウバン
行鳥	ギョウチョウ
獣吏	ジュウリ
三元	サンゲン
中元	チュウゲン
全国高等学校総合体育大会	ゼンコクコウトウガッコウソウゴウタイイクタイカイ
川西国鉄前駅	カワニシコクテツマエエキ
大村市	オオムラシ
精霊	セイレイ
嵯峨源氏	サガゲンジ
大都	ダイト
役牌	ヤクハイ
消化器	ショウカキ
下市田駅	シモイチダエキ
若林区	ワカバヤシク
太白区	タイハクク
近代映画社	キンダイエイガシャ
宝島社	タカラジマシャ
東久留米市	ヒガシクルメシ
津軽海峡	ツガルカイキョウ
山将	サンショウ
光文社	コウブンシャ
我孫子市	アビコシ
中庸	チュウヨウ
湖北駅	コホクエキ
門司駅	モジエキ
熱浸透率	ネツシントウリツ
藤田医科大学	フジタイカダイガク
法学者一覧	ホウガクシャイチラン
東邦大学	トウホウダイガク
日本の評論家一覧	ヒョウロンカイチラン
定気法	テイキホウ
御幣島駅	ミテジマエキ
獄門	ゴクモン
貨物船	カモツセン
腹上死	フクジョウシ
黒魔術	クロマジュツ
流局	リュウキョク
出力	シュツリョク
代数的整数	ダイスウテキセイスウ
気温減率	キオンゲンリツ
単相2線式	タンソウニセンシキ
無店舗販売	ムテンポハンバイ
一方向性関数	イチホウコウセイカンスウ
自動車検査登録制度	ジドウシャケンサトウロクセイド
随筆家	ズイヒツカ
学校法人総持学園	ガッコウホウジンソウジガクエン
大阪歯科大学	オオサカシカダイガク
聚楽園駅	シュウラクエンエキ
訪問販売	ホウモンハンバイ
移植	イショク
渦	ウズ
生物学者の一覧	セイブツガクシャノイチラン
電話勧誘販売	デンワカンユウハンバイ
天北線	テンポクセン
再帰	サイキ
西浦和駅	ニシウラワエキ
外戚	ガイセキ
和服	ワフク
戸田公園駅	トダコウエンエキ
尾久駅	オクエキ
名寄本線	ナヨロホンセン
上北沢駅	カミキタザワエキ
快適性評価	カイテキセイヒョウカ
乾球温度	カンキュウオンド
日本史時代区分表	ニホンシジダイクブンヒョウ
東京山手線内	トウキョウヤマノテセンナイ
三豊郡	ミトヨグン
結露	ケツロ
三方郡	ミカタグン
深谷市	フカヤシ
大竹市	オオタケシ
南流山駅	ミナミナガレヤマエキ
建築環境工学	ケンチクカンキョウコウガク
新子安駅	シンコヤスエキ
無政府共産主義	ムセイフキョウサンシュギ
山形線	ヤマガタセン
医薬品	イヤクヒン
士	シ
焼き鳥	ヤキトリ
記譜法	キフホウ
格言	カクゲン
谷	タニ
完全先付け	カンゼンサキヅケ
強制執行	キョウセイシッコウ
標津町	シベツチョウ
天城山	アマギサン
右将	ウショウ
左将	サショウ
民族服	ミンゾクフク
後旗	コウキ
小田急相模原駅	オダキュウサガミハラエキ
西葛西駅	ニシカサイエキ
北葛城郡	キタカツラギグン
横領罪	オウリョウザイ
寒河江市	サガエシ
西村山郡	ニシムラヤマグン
印旛郡	インバグン
香取郡	カトリグン
海上郡	カイジョウグン
匝瑳郡	ソウサグン
長生郡	チョウセイグン
小笠郡	オガサグン
東山梨郡	ヒガシヤマナシグン
東八代郡	ヒガシヤツシログン
西八代郡	ニシヤツシログン
南巨摩郡	ミナミコマグン
北巨摩郡	キタコマグン
中巨摩郡	ナカコマグン
北都留郡	キタツルグン
和歌山駅	ワカヤマエキ
鳳駅	オオトリエキ
日根野駅	ヒネノエキ
補給艦	ホキュウカン
膣内射精	チツナイシャセイ
枚方公園駅	ヒラカタコウエンエキ
日本海海戦記念式典	ニホンカイカイセンキネンシキテン
羅臼町	ラウスチョウ
むつ市	ムツシ
新社会党	シンシャカイトウ
福島市	フクシマシ
黒磯市	クロイソシ
龍ケ崎市	リュウガサキシ
日の出町	ヒノデマチ
安蘇郡	アソグン
獣曹	ジュウソウ
厚岸町	アッケシチョウ
地龍	チリュウ
奔鬼	ホンキ
牛久市	ウシクシ
浜中町	ハマナカチョウ
弘前藩	ヒロサキハン
山鷲	サンシュウ
火鬼	カキ
音別町	オンベツチョウ
宗主国	ソウシュコク
代理戦争	ダイリセンソウ
富士吉田市	フジヨシダシ
池田市	イケダシ
理論物理学	リロンブツリガク
風水	フウスイ
宮城郡	ミヤギグン
介護支援専門員	カイゴシエンセンモンイン
軽装甲機動車	ケイソウコウキドウシャ
省都	ショウト
浄土真宗本願寺派	ジョウドシンシュウホンガンジハ
爆雷	バクライ
明暦の大火	メイレキノタイカ
鯨鯢	ケイゲイ
走兎	ソウト
通商破壊	ツウショウハカイ
真宗大谷派	シンシュウオオタニハ
走熊	ソウユウ
部民制	ベミンセイ
応用物理学	オウヨウブツリガク
中華民国の国旗	チュウカミンコクノコッキ
TAGRO	タグロ
大和路快速	ヤマトジカイソク
上都賀郡	カミツガグン
泉南郡	センナングン
連鎖販売取引	レンサハンバイトリヒキ
肥筑方言	ヒチクホウゲン
小村井駅	オムライエキ
赤坂見附駅	アカサカミツケエキ
半蔵門駅	ハンゾウモンエキ
表参道駅	オモテサンドウエキ
青山一丁目駅	アオヤマイッチョウメエキ
九段下駅	クダンシタエキ
神保町駅	ジンボウチョウエキ
清澄白河駅	キヨスミシラカワエキ
邑智郡	オオチグン
文体	ブンタイ
分国法	ブンコクホウ
大将棋	ダイショウギ
順治帝	ジュンチテイ
織田氏	オダシ
消防	ショウボウ
大大将棋	ダイダイショウギ
長尾氏	ナガオシ
旅客船	リョカクセン
自然地理学	シゼンチリガク
あおば通駅	アオバドオリエキ
関東地震	カントウジシン
千羽鶴	センバヅル
東照宮駅	トウショウグウエキ
宇都宮氏	ウツノミヤウジ
泰将棋	タイショウギ
開成中学校	カイセイチュウガッコウ
雑学	ザツガク
自然主義	シゼンシュギ
伝記	デンキ
英文学	エイブンガク
教養小説	キョウヨウショウセツ
道徳劇	ドウトクゲキ
読者	ドクシャ
作者	サクシャ
特別支援教育	トクベツシエンキョウイク
化粧品	ケショウヒン
車兵	シャヘイ
野田市	ノダシ
天竺大将棋	テンジクダイショウギ
結核	ケッカク
震源	シンゲン
長居陸上競技場	ナガイリクジョウキョウギジョウ
声楽	セイガク
官庁	カンチョウ
葭川公園駅	ヨシカワコウエンエキ
楽曲	ガッキョク
自衛隊前駅	ジエイタイマエエキ
中京工業地帯	チュウキョウコウギョウチタイ
意識の流れ	イシキノナガレ
債権譲渡	サイケンジョウト
日本人論	ニホンジンロン
後期註釈学派	コウキチュウシャクガクハ
朗読	ロウドク
工房	コウボウ
公害	コウガイ
工業地域	コウギョウチイキ
児童	ジドウ
石将	セキショウ
土将	ドショウ
金車	キンシャ
銀車	ギンシャ
木車	モクシャ
石車	セキシャ
瓦車	ガシャ
土車	ドシャ
日野市	ヒノシ
座席車	ザセキシャ
川崎球場	カワサキキュウジョウ
平和台野球場	ヘイワダイヤキュウジョウ
性的少数者	セイテキショウスウシャ
炮兵	ホウヘイ
浄土真宗親鸞会	ジョウドシンシュウシンランカイ
川将	センショウ
契丹文字	キッタンモジ
風将	フウショウ
港湾工学	コウワンコウガク
断頭台	ダントウダイ
大亀	ダイキ
小亀	ショウキ
淮鶏	ワイケイ
馬廻	ウママワリ
帯広市	オビヒロシ
下水道	ゲスイドウ
けやき台駅	ケヤキダイエキ
楚漢戦争	ソカンセンソウ
平沼橋駅	ヒラヌマバシエキ
海水	カイスイ
環状通東駅	カンジョウドオリヒガシエキ
脱学校論	ダツガッコウロン
総合	ソウゴウ
赤井川村	アカイガワムラ
勝田駅	カツタエキ
曲率	キョクリツ
迷信	メイシン
狼男	オオカミオトコ
大量虐殺	タイリョウギャクサツ
風馬	フウマ
曳舟駅	ヒキフネエキ
鶏飛	ケイヒ
現代仮名遣い	ゲンダイカナヅカイ
87式自走高射機関砲	ハチナナシキジソウコウシャキカンホウ
柴又駅	シバマタエキ
昔話	ムカシバナシ
石狩山地	イシカリサンチ
泉中央駅	イズミチュウオウエキ
筑後川	チクゴガワ
渡島小島	オシマコジマ
寓話	グウワ
歴史劇	レキシゲキ
黄母衣衆	キボロシュウ
母衣	ホロ
放出駅	ハナテンエキ
国民政府	コクミンセイフ
基山駅	キヤマエキ
極楽寺駅	ゴクラクジエキ
封建国家	ホウケンコッカ
稲村ヶ崎駅	イナムラガサキエキ
大回転	ダイカイテン
高潮	タカシオ
光球	コウキュウ
彩層	サイソウ
磁気嵐	ジキアラシ
子嬰	シエイ
猛禽類	モウキンルイ
摂津富田駅	セッツトンダエキ
網干総合車両所	アボシソウゴウシャリョウショ
胡亥	コガイ
遠視	エンシ
大通駅	オオドオリエキ
廟	ビョウ
提婆	ダイバ
大阪城北詰駅	オオサカジョウキタヅメエキ
北新地駅	キタシンチエキ
和将棋	ワショウギ
姫路城	ヒメジジョウ
鳥栖駅	トスエキ
日東駒専	ニットウコマセン
草加市	ソウカシ
新小岩駅	シンコイワエキ
粘着榴弾	ネンチャクリュウダン
上峰町	カミミネチョウ
北茂安町	キタシゲヤスチョウ
三根町	ミネチョウ
電気自動車	デンキジドウシャ
勾留	コウリュウ
人間の骨の一覧	ニンゲンノホネノイチラン
音波	オンパ
川副町	カワソエマチ
久保田町	クボタチョウ
東与賀町	ヒガシヨカチョウ
諸富町	モロドミチョウ
神埼町	カンザキマチ
三田川町	ミタガワチョウ
脊振村	セフリムラ
佐賀郡	サガグン
芦刈町	アシカリチョウ
小城郡	オギグン
東松浦郡	ヒガシマツウラグン
七山村	ナナヤマムラ
厳木町	キュウラギマチ
玄海町	ゲンカイチョウ
西松浦郡	ニシマツウラグン
有田町	アリタチョウ
杵島郡	キシマグン
藤津郡	フジツグン
美佐島駅	ミサシマエキ
十日町駅	トオカマチエキ
塩沢駅	シオザワエキ
石打駅	イシウチエキ
終止形	シュウシケイ
有袋類	ユウタイルイ
盲犬	モウケン
猛狼	モウロウ
仮想世界	カソウセカイ
市街地	シガイチ
徳庵駅	トクアンエキ
鶴見緑地駅	ツルミリョクチエキ
花博記念公園鶴見緑地	ハナハクキネンコウエンツルミリョクチ
門真南駅	カドマミナミエキ
鳳師	ホウシ
麟師	リンシ
中師	チュウシ
片町駅	カタマチエキ
猫刄	ミョウジン
嗔猪	シンチョ
猛牛	モウギュウ
鴫野駅	シギノエキ
血管	ケッカン
十和田観光電鉄線	トワダカンコウデンテツセン
淋病	リンビョウ
原爆症	ゲンバクショウ
うしかい座	ウシカイザ
かみのけ座	カミノケザ
くじゃく座	クジャクザ
くじら座	クジラザ
こいぬ座	コイヌザ
こぎつね座	コギツネザ
こと座	コトザ
じょうぎ座	ジョウギザ
とかげ座	トカゲザ
はくちょう座	ハクチョウザ
膀胱	ボウコウ
不斉合成	フセイゴウセイ
加古川駅	カコガワエキ
早川書房	ハヤカワショボウ
大阪新聞	オオサカシンブン
心身症	シンシンショウ
倭の五王	ワノゴオウ
部首	ブシュ
国際電話	コクサイデンワ
へび座	ヘビザ
へびつかい座	ヘビツカイザ
りゅうこつ座	リュウコツザ
わし座	ワシザ
大革命	ダイカクメイ
邇摩郡	ニマグン
美濃郡	ミノグン
鹿足郡	カノアシグン
亘理郡	ワタリグン
加美郡	カミグン
玉造郡	タマツクリグン
遠田郡	トオダグン
かじき座	カジキザ
三相3線式	サンソウサンセンシキ
とびうお座	トビウオザ
永劫回帰	エイゴウカイキ
白駒	ハクク
豊能郡	トヨノグン
かんむり座	カンムリザ
飛鹿	ヒロク
澄川駅	スミカワエキ
和名	ワメイ
泉北郡	センボクグン
京葉道路	ケイヨウドウロ
南河内郡	ミナミカワチグン
CISC	シスク
伊具郡	イググン
登米郡	トメグン
桃生郡	モノウグン
牡鹿郡	オシカグン
本吉郡	モトヨシグン
神武寺駅	ジンムジエキ
高槻駅	タカツキエキ
角鷹	カクオウ
ちょうこくしつ座	チョウコクシツザ
とけい座	トケイザ
はちぶんぎ座	ハチブンギザ
海上警備隊	カイジョウケイビタイ
ほ座	ホザ
国教	コッキョウ
福工大前駅	フッコウダイマエエキ
ぼうえんきょう座	ボウエンキョウザ
らしんばん座	ラシンバンザ
ろくぶんぎ座	ロクブンギザ
全日本大学野球連盟	ゼンニホンダイガクヤキュウレンメイ
一般放送事業者	イッパンホウソウジギョウシャ
委託放送事業者	イタクホウソウジギョウシャ
受託放送事業者	ジュタクホウソウジギョウシャ
辛亥革命	シンガイカクメイ
知多市	チタシ
XUXU	シュシュ
奔鷲	ホンジュウ
石手川公園駅	イシテガワコウエンエキ
いよ立花駅	イヨタチバナエキ
大船観音寺	オオフナカンノンジ
民主政	ミンシュセイ
骨格筋	コッカクキン
筋紡錘	キンボウスイ
糟屋郡	カスヤグン
宗像郡	ムナカタグン
遠賀郡	オンガグン
鞍手郡	クラテグン
嘉穂郡	カホグン
朝倉郡	アサクラグン
糸島郡	イトシマグン
再臨	サイリン
浮羽郡	ウキハグン
三井郡	ミイグン
八女郡	ヤメグン
山門郡	ヤマトグン
三池郡	ミイケグン
領土	リョウド
田川郡	タガワグン
築上郡	チクジョウグン
丹銅	タンドウ
新道東駅	シンドウヒガシエキ
遠賀川駅	オンガガワエキ
丹波篠山市	タンバササヤマシ
名賀郡	ナガグン
日朝修好条規	ニッチョウシュウコウジョウキ
刺股	サスマタ
文学理論	ブンガクリロン
塩釜駅	シオガマエキ
豊富町	トヨトミチョウ
中頓別町	ナカトンベツチョウ
枝幸町	エサシチョウ
歌登町	ウタノボリチョウ
礼文町	レブンチョウ
利尻町	リシリチョウ
利尻富士町	リシリフジチョウ
猿払村	サルフツムラ
本塩釜駅	ホンシオガマエキ
友愛数	ユウアイスウ
皿屋敷	サラヤシキ
清掃工場	セイソウコウジョウ
板橋区役所前駅	イタバシクヤクショマエエキ
地盤沈下	ジバンチンカ
字句解析	ジクカイセキ
余目町	アマルメマチ
東田川郡	ヒガシタガワグン
西田川郡	ニシタガワグン
北村山郡	キタムラヤマグン
最上郡	モガミグン
東置賜郡	ヒガシオキタマグン
西置賜郡	ニシオキタマグン
飽海郡	アクミグン
余目駅	アマルメエキ
高松宮記念杯競輪	タカマツノミヤキネンハイケイリン
博多区	ハカタク
太鼓	タイコ
帝銀事件	テイギンジケン
獅鷹	シオウ
禽曹	キンソウ
禽吏	キンリ
吼犬	コウケン
株式分割	カブシキブンカツ
即興演奏	ソッキョウエンソウ
木更津市	キサラヅシ
手児奈	テコナ
大和川	ヤマトガワ
東京創元社	トウキョウソウゲンシャ
肛門	コウモン
力積	リキセキ
井波駅	イナミエキ
放射温度計	ホウシャオンドケイ
嫌韓	ケンカン
島田市	シマダシ
お台場	オダイバ
平均寿命	ヘイキンジュミョウ
論	ロン
真正町	シンセイチョウ
逆瀬川駅	サカセガワエキ
甲東園駅	コウトウエンエキ
放射年代測定	ホウシャネンダイソクテイ
中山寺駅	ナカヤマデラエキ
烏行	ウコウ
鴟行	シギョウ
燕羽	エンウ
札幌厚別公園競技場	サッポロアツベツコウエンキョウギジョウ
右虎	ウコ
左虎	サコ
右車	ウシャ
左車	サシャ
北海道新聞社	ホッカイドウシンブンシャ
水晶体	スイショウタイ
白内障	ハクナイショウ
明和	メイワ
員弁郡	イナベグン
仏堂	ブツドウ
二条御所	ニジョウゴショ
民営化	ミンエイカ
木次町	キスキチョウ
亀岡駅	カメオカエキ
馬堀駅	ウマホリエキ
まつだい駅	マツダイエキ
くびき駅	クビキエキ
朝鮮民主主義人民共和国の地方行政区画	チョウセンミンシュシュギジンミンキョウワコクノチホウギョウセイクカク
久地駅	クジエキ
広島弁	ヒロシマベン
令制	リョウセイ
心	ココロ
右大臣	ウダイジン
内大臣	ナイダイジン
糸貫町	イトヌキチョウ
根尾村	ネオムラ
古賀駅	コガエキ
しんぶん赤旗	シンブンアカハタ
多摩丘陵	タマキュウリョウ
古典派音楽の作曲家一覧	コテンハオンガクノサッキョクカイチラン
塚本駅	ツカモトエキ
通奏低音	ツウソウテイオン
角砂糖	カクザトウ
伊都国	イトコク
竜田揚げ	タツタアゲ
数字付き低音	スウジツキテイオン
加島駅	カシマエキ
川崎区	カワサキク
粉食	コショク
須佐駅	スサエキ
片栗粉	カタクリコ
蕎麦粉	ソバコ
葛粉	クズコ
天満駅	テンマエキ
桜ノ宮駅	サクラノミヤエキ
日本の上代文学史	ニホンノジョウダイブンガクシ
日本の中世文学史	ニホンノチュウセイブンガクシ
日本の中古文学史	ニホンノチュウコブンガクシ
宿河原駅	シュクガワラエキ
蕎麦殻	ソバガラ
弁天町駅	ベンテンチョウエキ
芦原橋駅	アシハラバシエキ
焼き物	ヤキモノ
寺田町駅	テラダチョウエキ
桃谷駅	モモダニエキ
玉造駅	タマツクリエキ
安政	アンセイ
森ノ宮駅	モリノミヤエキ
巣南町	スナミチョウ
今宮駅	イマミヤエキ
大阪天満宮駅	オオサカテンマングウエキ
新福島駅	シンフクシマエキ
海老江駅	エビエエキ
穂積町	ホヅミチョウ
白夜書房	ビャクヤショボウ
大量絶滅	タイリョウゼツメツ
だだちゃ豆	ダダチャマメ
社家駅	シャケエキ
本巣町	モトスチョウ
遣隋使	ケンズイシ
片浜駅	カタハマエキ
相国	ショウコク
新潟空港	ニイガタクウコウ
天明	テンメイ
高幡不動駅	タカハタフドウエキ
比熱比	ヒネツヒ
冷麺	レイメン
三菱銀行	ミツビシギンコウ
四天王寺	シテンノウジ
国璽	コクジ
川島町	カワジママチ
立花駅	タチバナエキ
甲子園口駅	コウシエングチエキ
甲南山手駅	コウナンヤマテエキ
摂津本山駅	セッツモトヤマエキ
六甲道駅	ロッコウミチエキ
灘駅	ナダエキ
兵庫駅	ヒョウゴエキ
鷹取駅	タカトリエキ
垂水駅	タルミエキ
舞子駅	マイコエキ
明石駅	アカシエキ
政見放送	セイケンホウソウ
銃剣	ジュウケン
放送対象地域	ホウソウタイショウチイキ
広域圏	コウイキケン
広域放送	コウイキホウソウ
県域放送	ケンイキホウソウ
立川北駅	タチカワキタエキ
立川南駅	タチカワミナミエキ
八軒駅	ハチケンエキ
少数民族	ショウスウミンゾク
銃剣道	ジュウケンドウ
坂町駅	サカマチエキ
平木田駅	ヒラキダエキ
大阪天満宮	オオサカテンマングウ
寛延	カンエン
延享	エンキョウ
八乙女駅	ヤオトメエキ
元文	ゲンブン
免許	メンキョ
乱視	ランシ
大聖観音寺	ダイショウカンノンジ
国体論争	コクタイロンソウ
伊那市駅	イナシエキ
戦闘機一覧	セントウキイチラン
妙典駅	ミョウデンエキ
禽将棋	トリショウギ
古代日本の戸籍制度	コダイニホンノコセキセイド
不良債権	フリョウサイケン
安南将棋	アンナンショウギ
京都将棋	キョウトショウギ
熱力学第二法則	ネツリキガクダイニホウソク
波動方程式	ハドウホウテイシキ
保安官	ホアンカン
松田駅	マツダエキ
魚住駅	ウオズミエキ
土山駅	ツチヤマエキ
東加古川駅	ヒガシカコガワエキ
西条市	サイジョウシ
四国中央市	シコクチュウオウシ
宇和島市	ウワジマシ
西予市	セイヨシ
万治	マンジ
西晋	セイシン
日英同盟	ニチエイドウメイ
前立腺癌	ゼンリツセンガン
世界宗教	セカイシュウキョウ
保谷市	ホウヤシ
西関東方言	ニシカントウホウゲン
独立放送局	ドクリツホウソウキョク
給電線	キュウデンセン
深夜放送	シンヤホウソウ
全国放送	ゼンコクホウソウ
東夷	トウイ
標津線	シベツセン
和漢混淆文	ワカンコンコウブン
宝殿駅	ホウデンエキ
北本駅	キタモトエキ
浅口郡	アサクチグン
音響学	オンキョウガク
赤磐郡	アカイワグン
和気郡	ワケグン
赤穂郡	アコウグン
揖保郡	イボグン
消火器	ショウカキ
外国語放送	ガイコクゴホウソウ
脳低温療法	ノウテイオンリョウホウ
新高島駅	シンタカシマエキ
みなとみらい駅	ミナトミライエキ
馬車道駅	バシャミチエキ
日本大通り駅	ニホンオオドオリエキ
山下公園	ヤマシタコウエン
神奈川新町駅	カナガワシンマチエキ
戸部駅	トベエキ
関内駅	カンナイエキ
なか卯	ナカウ
新杉田駅	シンスギタエキ
賀茂御祖神社	カモミオヤジンジャ
賀茂別雷神社	カモワケイカヅチジンジャ
八方桂	ハッポウケイ
守口市	モリグチシ
賀茂神社	カモジンジャ
日本経済新聞社	ニホンケイザイシンブンシャ
三条市	サンジョウシ
日野台地	ヒノダイチ
国際放送	コクサイホウソウ
楚	ソ
博多南駅	ハカタミナミエキ
山陽新聞	サンヨウシンブン
東京奠都	トウキョウテント
東淀川駅	ヒガシヨドガワエキ
新千歳空港駅	シンチトセクウコウエキ
政治用語一覧	セイジヨウゴイチラン
グリコシド結合	グリコシドケツゴウ
帯広駅	オビヒロエキ
北硫黄島	キタイオウトウ
高田郡	タカタグン
南硫黄島	ミナミイオウトウ
火山列島	カザンレットウ
岸辺駅	キシベエキ
千里丘駅	センリオカエキ
西大路駅	ニシオオジエキ
向日町駅	ムコウマチエキ
札幌駅	サッポロエキ
長岡京駅	ナガオカキョウエキ
無反動砲	ムハンドウホウ
国共合作	コッキョウガッサク
中波放送	チュウハホウソウ
超短波放送	チョウタンパホウソウ
韓国の政党一覧	カンコクノセイトウイチラン
自由韓国党	ジユウカンコクトウ
官幣大社	カンペイタイシャ
国幣大社	コクヘイタイシャ
吹田市	スイタシ
調律	チョウリツ
石巻市	イシノマキシ
滑走路	カッソウロ
乙訓郡	オトクニグン
八丈小島	ハチジョウコジマ
二酸化窒素	ニサンカチッソ
綴喜郡	ツヅキグン
北桑田郡	キタクワダグン
天田郡	アマタグン
加佐郡	カサグン
熊野郡	クマノグン
いわき市	イワキシ
都道府県知事	トドウフケンチジ
応永	オウエイ
趙	チョウ
六国史	リッコクシ
川辺郡	カワベグン
猪名川町	イナガワチョウ
一関藩	イチノセキハン
山陰中央新報	サンインチュウオウシンポウ
深名線	シンメイセン
臨床検査技師	リンショウケンサギシ
横綱	ヨコヅナ
木曽山脈	キソサンミャク
赤石山脈	アカイシサンミャク
成人向け漫画	セイジンムケマンガ
精神保健福祉士	セイシンホケンフクシシ
臨床検査	リンショウケンサ
社会的少数者	シャカイテキショウスウシャ
異文化	イブンカ
聴覚障害者	チョウカクショウガイシャ
黄櫨染御袍	コウロゼンノゴホウ
亜熱帯	アネッタイ
防共協定	ボウキョウキョウテイ
永久機関	エイキュウキカン
高岡市	タカオカシ
鴨宮駅	カモノミヤエキ
配牌	ハイパイ
玉縄城	タマナワジョウ
漢詩	カンシ
南草津駅	ミナミクサツエキ
県立大学駅	ケンリツダイガクエキ
旗の台駅	ハタノダイエキ
火薬	カヤク
三代橋駅	ミダイバシエキ
港湾	コウワン
仕事率	シゴトリツ
台原駅	ダイノハラエキ
豪雪地帯	ゴウセツチタイ
磯子駅	イソゴエキ
差音	サオン
茂原駅	モバラエキ
演奏記号	エンソウキゴウ
横須賀中央駅	ヨコスカチュウオウエキ
閉包	ヘイホウ
鶴岡八幡宮	ツルガオカハチマングウ
青物横丁駅	アオモノヨコチョウエキ
鮫洲駅	サメズエキ
立会川駅	タチアイガワエキ
平和島駅	ヘイワジマエキ
大森海岸駅	オオモリカイガンエキ
大森町駅	オオモリマチエキ
大森駅	オオモリエキ
離婚	リコン
共済	キョウサイ
二重課税	ニジュウカゼイ
減価償却	ゲンカショウキャク
冷やし中華	ヒヤシチュウカ
軍歌	グンカ
二戸市	ニノヘシ
中標津空港	ナカシベツクウコウ
外国所得免税	ガイコクショトク
信託銀行	シンタクギンコウ
貸借対照表	タイシャクタイショウヒョウ
準備金	ジュンビキン
梅小路蒸気機関車館	ウメコウジジョウキキカンシャカン
四国新幹線	シコクシンカンセン
銭洲	ゼニス
石山駅	イシヤマエキ
膳所駅	ゼゼエキ
大津駅	オオツエキ
山科駅	ヤマシナエキ
静岡県立大学	シズオカケンリツダイガク
絶句	ゼック
律詩	リッシ
全国赤帽軽自動車運送協同組合連合会	ゼンコクアカボウケイジドウシャウンソウキョウドウクミアイレンゴウカイ
彦根駅	ヒコネエキ
南彦根駅	ミナミヒコネエキ
村落	ソンラク
発声器官	ハッセイキカン
清水市	シミズシ
集村	シュウソン
環村	タマキムラ
散居村	サンキョソン
北四番丁駅	キタヨバンチョウエキ
租税競争	ソゼイキョウソウ
稲枝駅	イナエエキ
峠	トウゲ
北松戸駅	キタマツドエキ
網膜剥離	モウマクハクリ
飛蚊症	ヒブンショウ
南千歳駅	ミナミチトセエキ
目玉焼き	メダマヤキ
手塚治虫文化賞	テヅカオサムブンカショウ
のんのん婆	ノンノンバア
顔料	ガンリョウ
蛇頭	ジャトウ
電線	デンセン
放射光	ホウシャコウ
粒子放射線	リュウシホウシャセン
岩見沢市	イワミザワシ
竪狗	シュク
竪馬	シュバ
竪豹	シュヒョウ
火将	カショウ
瑞穂市	ミズホシ
水将	スイショウ
女満別町	メマンベツチョウ
竪虎	シュコ
開かれたウリ党	ヒラカレタウリトウ
竪熊	シュユウ
利己主義	リコシュギ
能登川駅	ノトガワエキ
安土駅	アヅチエキ
大垣市	オオガキシ
近江八幡駅	オウミハチマンエキ
野洲駅	ヤスエキ
勾当台公園駅	コウトウダイコウエンエキ
視覚障害者	シカクショウガイシャ
栗東駅	リットウエキ
因島市	インノシマシ
山形県総合運動公園	ヤマガタケンソウゴウウンドウコウエン
笠松運動公園陸上競技場	カサマツウンドウコウエンリクジョウキョウギジョウ
阿毘達磨倶舎論	アビダツマクシャロン
東平尾公園	ヒガシヒラオコウエン
北関東工業地域	キタカントウコウギョウチイキ
中津川市	ナカツガワシ
正中	セイチュウ
軍閥	グンバツ
人虎	ジンコ
甘藷	カンショ
北伐	ホクバツ
北洋軍閥	ホクヨウグンバツ
綏遠省	スイエンショウ
独立宣言	ドクリツセンゲン
桜島駅	サクラジマエキ
各務原市	カカミガハラシ
奇蹄目	キテイモク
毎日新聞社	マイニチシンブンシャ
偶蹄目	グウテイモク
安治川口駅	アジカワグチエキ
鹿児島中央駅	カゴシマチュウオウエキ
天井川	テンジョウガワ
連絡運輸	レンラクウンユ
御津郡	ミツグン
児島郡	コジマグン
都窪郡	ツクボグン
吉備郡	キビグン
小田郡	オダグン
後月郡	シツキグン
上房郡	ジョウボウグン
阿哲郡	アテツグン
苫田郡	トマタグン
渡良瀬遊水地	ワタラセユウスイチ
缶詰	カンヅメ
棋力	キリョク
打刀	ウチガタナ
打ち歩詰め	ウチフヅメ
広瀬通駅	ヒロセドオリエキ
五橋駅	イツツバシエキ
庄和町	ショウワマチ
正規部分群	セイキブブングン
洪武	コウブ
長町駅	ナガマチエキ
長町一丁目駅	ナガマチイッチョウメエキ
愛宕橋駅	アタゴバシエキ
つくば駅	ツクバエキ
津久井浜駅	ツクイハマエキ
北久里浜駅	キタクリハマエキ
東三国駅	ヒガシミクニエキ
西中島南方駅	ニシナカジマミナミガタエキ
本町駅	ホンマチエキ
心斎橋駅	シンサイバシエキ
薩摩郡	サツマグン
姶良郡	アイラグン
肝属郡	キモツキグン
伊佐郡	イサグン
出水郡	イズミグン
揖宿郡	イブスキグン
鹿児島郡	カゴシマグン
高知県立春野運動公園野球場	コウチケンリツハルノウンドウコウエンヤキュウジョウ
安芸市営球場	アキシエイキュウジョウ
日刊県民福井	ニッカンケンミンフクイ
期限付き移籍	キゲンツキイセキ
愛別岳	アイベツダケ
宇部日報	ウベニッポウ
北海道の山の一覧	ホッカイドウノヤマノイチラン
照明	ショウメイ
冷房	レイボウ
建文	ケンブン
洪熙帝	コウキテイ
堯	ギョウ
快楽主義	カイラクシュギ
星座の広さ順の一覧	セイザノヒロサジュンノイチラン
熱力学温度	ネツリキガクオンド
読本	ヨミホン
固定翼機	コテイヨクキ
本巣郡	モトスグン
海津郡	カイヅグン
養老郡	ヨウロウグン
安八郡	アンパチグン
義体化	ギタイカ
揖斐郡	イビグン
郡上郡	グジョウグン
可児郡	カニグン
恵那郡	エナグン
土岐郡	トキグン
益田郡	マシタグン
壱岐郡	イキグン
国頭郡	クニガミグン
中頭郡	ナカガミグン
島尻郡	シマジリグン
宮古郡	ミヤコグン
英田郡	アイダグン
大国町駅	ダイコクチョウエキ
勝田郡	カツタグン
久米郡	クメグン
動物園前駅	ドウブツエンマエエキ
和賀郡	ワガグン
東磐井郡	ヒガシイワイグン
気仙郡	ケセングン
上閉伊郡	カミヘイグン
下閉伊郡	シモヘイグン
九戸郡	クノヘグン
我	ガ
西田辺駅	ニシタナベエキ
長居駅	ナガイエキ
北花田駅	キタハナダエキ
新金岡駅	シンカナオカエキ
識別不能	シキベツフノウ
警備局	ケイビキョク
広宣流布	コウセンルフ
留萌市	ルモイシ
肥後橋駅	ヒゴバシエキ
羽幌町	ハボロチョウ
静岡新聞	シズオカシンブン
興津	オキツ
将棋類の駒の一覧	ショウギルイノコマノイチラン
坂田郡	サカタグン
東浅井郡	ヒガシアザイグン
犬上郡	イヌカミグン
野洲郡	ヤスグン
滋賀郡	シガグン
不正乗車	フセイジョウシャ
富山藩	トヤマハン
乗換駅	ノリカエエキ
谷中村	ヤナカムラ
環形動物	カンケイドウブツ
弱視	ジャクシ
神道用語一覧	シントウヨウゴイチラン
二乗	ニジョウ
秋田書店	アキタショテン
川越市駅	カワゴエシエキ
規制	キセイ
南大塚駅	ミナミオオツカエキ
吉田神社	ヨシダジンジャ
広電	コウデン
朝鮮籍	チョウセンセキ
千里中央駅	センリチュウオウエキ
県庁所在地	ケンチョウショザイチ
飾磨駅	シカマエキ
内分泌攪乱物質	ナイブンピツカクランブッシツ
倶舎宗	クシャシュウ
花園町駅	ハナゾノチョウエキ
住之江公園駅	スミノエコウエンエキ
美々信号場	ビビシンゴウジョウ
公共	コウキョウ
自尊心	ジソンシン
保釈	ホシャク
魚つき林	ウオツキリン
防衛	ボウエイ
正当防衛	セイトウボウエイ
汁男優	シルダンユウ
国防	コクボウ
西梅田駅	ニシウメダエキ
唯心論	ユイシンロン
淡墨桜	ウスズミザクラ
白井市	シロイシ
東梅田駅	ヒガシウメダエキ
七尾駅	ナナオエキ
京浜工業地帯	ケイヒンコウギョウチタイ
無視可能函数	ムシカノウカンスウ
石狩郡	イシカリグン
厚田郡	アツタグン
浜益郡	ハママスグン
札幌郡	サッポログン
古川町	フルカワチョウ
岐阜新聞	ギフシンブン
流星群	リュウセイグン
民集	ミンシュウ
報知新聞社	ホウチシンブンシャ
特定調停	トクテイチョウテイ
京都総合運転所	キョウトソウゴウウンテンジョ
根の国	ネノクニ
登呂遺跡	トロイセキ
久能山東照宮	クノウザントウショウグウ
完全競争	カンゼンキョウソウ
日立電鉄線	ヒタチデンテツセン
首都機能移転	シュトキノウイテン
上裏	アゲウラ
朝鮮民族	チョウセンミンゾク
吉備国	キビノクニ
東海工業地域	トウカイコウギョウチイキ
第二東海自動車道	ダイニトウカイジドウシャドウ
室蘭市	ムロランシ
単糖	タントウ
特定機能病院	トクテイキノウビョウイン
勝木駅	ガツギエキ
南森町駅	ミナミモリマチエキ
阪神工業地帯	ハンシンコウギョウチタイ
堺筋本町駅	サカイスジホンマチエキ
恵美須町駅	エビスチョウエキ
休日	キュウジツ
千里丘陵	センリキュウリョウ
測地系	ソクチケイ
民事介入暴力	ミンジカイニュウボウリョク
石上駅	イシガミエキ
憲兵	ケンペイ
開発援助	カイハツエンジョ
土浦市	ツチウラシ
地上駅	チジョウエキ
橋上駅	キョウジョウエキ
持続可能性	ジゾクカノウセイ
大深度地下	ダイシンドチカ
人民公社	ジンミンコウシャ
仏舎利	ブッシャリ
名家	メイカ
名水	メイスイ
瀬戸内工業地域	セトウチコウギョウチイキ
北陸工業地域	ホクリクコウギョウチイキ
日本の滝百選	ニホンノタキヒャクセン
正徳の治	ショウトクノチ
大阪港駅	オオサカコウエキ
朝潮橋駅	アサシオバシエキ
阿波座駅	アワザエキ
谷町四丁目駅	タニマチヨンチョウメエキ
湘南色	ショウナンショク
緑橋駅	ミドリバシエキ
深江橋駅	フカエバシエキ
洪水	コウズイ
東青森駅	ヒガシアオモリエキ
生物濃縮	セイブツノウシュク
木炭	モクタン
双眼鏡	ソウガンキョウ
神戸	コウベ
三十六歌仙	サンジュウロッカセン
中古三十六歌仙	チュウコサンジュウロッカセン
相川町	アイカワマチ
川崎病	カワサキビョウ
谷町九丁目駅	タニマチキュウチョウメエキ
新深江駅	シンフカエエキ
哲学者	テツガクシャ
騸馬	センバ
愛知医科大学	アイチイカダイガク
烏帽子岩	エボシイワ
国領駅	コクリョウエキ
句読点	クトウテン
金本位制	キンホンイセイ
不換紙幣	フカンシヘイ
三相4線式	サンソウヨンセンシキ
純文学	ジュンブンガク
赤緯	セキイ
中間小説	チュウカンショウセツ
田鶴浜駅	タツルハマエキ
笠師保駅	カサシホエキ
旅伏駅	タブシエキ
金神	コンジン
えひめ丸	エヒメマル
拈華微笑	ネンゲミショウ
台湾海峡	タイワンカイキョウ
朝鮮海峡	チョウセンカイキョウ
西長堀駅	ニシナガホリエキ
万暦帝	バンレキテイ
崇禎	スウテイ
崇禎帝	スウテイテイ
金井町	カナイマチ
北巽駅	キタタツミエキ
南巽駅	ミナミタツミエキ
鶴巻温泉駅	ツルマキオンセンエキ
御膳味噌	ゴゼンミソ
松屋町駅	マツヤマチエキ
谷町六丁目駅	タニマチロクチョウメエキ
西大橋駅	ニシオオハシエキ
金山寺味噌	キンザンジミソ
改元	カイゲン
無輸血治療	ムユケツチリョウ
津田山駅	ツダヤマエキ
平間駅	ヒラマエキ
結界	ケッカイ
向河原駅	ムカイガワラエキ
体罰	タイバツ
鹿児島県立大学	カゴシマケンリツダイガク
丹波路快速	タンバジカイソク
薩長同盟	サッチョウドウメイ
質量保存の法則	シツリョウホゾンノホウソク
両院制	リョウインセイ
南仙台駅	ミナミセンダイエキ
馬力	バリキ
膠原病	コウゲンビョウ
蒲生四丁目駅	ガモウヨンチョウメエキ
今福鶴見駅	イマフクツルミエキ
横堤駅	ヨコヅツミエキ
守口駅	モリグチエキ
殉死	ジュンシ
榴ケ岡駅	ツツジガオカエキ
人材	ジンザイ
集団自殺	シュウダンジサツ
相模湾	サガミワン
大日駅	ダイニチエキ
宮城野原駅	ミヤギノハラエキ
陸前原ノ町駅	リクゼンハラノマチエキ
新湊線	シンミナトセン
小路駅	ショウジエキ
書記言語	ショキゲンゴ
紀伊民報	キイミンポウ
親権	シンケン
第三国人	ダイサンゴクジン
苦竹駅	ニガタケエキ
ひみつ道具	ヒミツドウグ
字	アザナ
条約の一覧	ジョウヤクノイチラン
新高円寺駅	シンコウエンジエキ
佐和田町	サワタマチ
高円寺駅	コウエンジエキ
東日本放送	ヒガシニッポンホウソウ
越後田沢駅	エチゴタザワエキ
鰭脚類	キキャクルイ
夕張郡	ユウバリグン
結婚式場	ケッコンシキジョウ
樺戸郡	カバトグン
雨竜郡	ウリュウグン
遠国奉行	オンゴクブギョウ
太子橋今市駅	タイシバシイマイチエキ
関目高殿駅	セキメタカドノエキ
上越市	ジョウエツシ
野江内代駅	ノエウチンダイエキ
中崎町駅	ナカザキチョウエキ
四天王寺前夕陽ヶ丘駅	シテンノウジマエユウヒガオカエキ
阿倍野駅	アベノエキ
文の里駅	フミノサトエキ
駒川中野駅	コマガワナカノエキ
喜連瓜破駅	キレウリワリエキ
出戸駅	デトエキ
八尾南駅	ヤオミナミエキ
国際拠点港湾	コクサイキョテンコウワン
八尾市	ヤオシ
日本平	ニホンダイラ
育種学	イクシュガク
数秘術	スウヒジュツ
伊那市	イナシ
外国人犯罪	ガイコクジンハンザイ
意志	イシ
年度代表馬	ネンドダイヒョウバ
道路元標	ドウロゲンピョウ
距離標	キョリヒョウ
南摂津駅	ミナミセッツエキ
都市施設	トシシセツ
葛西臨海公園駅	カサイリンカイコウエンエキ
潮見駅	シオミエキ
諱	イミナ
電子投票	デンシトウヒョウ
岐阜駅前駅	ギフエキマエエキ
万博記念競技場	バンパクキネンキョウギジョウ
人権団体	ジンケンダンタイ
深成岩	シンセイガン
火山岩	カザンガン
変成岩	ヘンセイガン
必殺技	ヒッサツワザ
自由席	ジユウセキ
未成線	ミセイセン
主体	シュタイ
毬杖	ギッチョウ
座席指定席	ザセキシテイセキ
精進川	ショウジンガワ
人智学	ジンチガク
風土記	フドキ
緑地公園駅	リョクチコウエンエキ
桃山台駅	モモヤマダイエキ
南港東駅	ナンコウヒガシエキ
川西航空機	カワニシコウクウキ
崇禅寺駅	ソウゼンジエキ
上新庄駅	カミシンジョウエキ
相川駅	アイカワエキ
付加価値	フカカチ
流紋岩	リュウモンガン
安山岩	アンザンガン
落武者	オチムシャ
京都新聞	キョウトシンブン
片麻岩	ヘンマガン
大理石	ダイリセキ
上京区	カミギョウク
蛇紋岩	ジャモンガン
農学部	ノウガクブ
摂津駅	セッツエキ
回数券	カイスウケン
柴島駅	クニジマエキ
松島海岸駅	マツシマカイガンエキ
黄金律	オウゴンリツ
回数乗車券	カイスウジョウシャケン
音叉	オンサ
旭川競馬場	アサヒカワケイバジョウ
竹原市	タケハラシ
斉	セイ
商学部	ショウガクブ
法定通貨	ホウテイツウカ
大猷院	タイユウイン
南日本新聞	ミナミニッポンシンブン
生理学	セイリガク
関大前駅	カンダイマエエキ
千里山駅	センリヤマエキ
南千里駅	ミナミセンリエキ
無機化合物	ムキカゴウブツ
真野町	マノマチ
演歌	エンカ
演歌歌手	エンカカシュ
総持寺駅	ソウジジエキ
さっぽろ駅	サッポロエキ
共鳴	キョウメイ
美術書	ビジュツショ
紀元前525年	キゲンゼンゴヒャクニジュウゴネン
紀元前446年	キゲンゼンヨンヒャクヨンジュロクネン
稲子駅	イナコエキ
知識工学	チシキコウガク
浮力	フリョク
浦和区	ウラワク
招き猫	マネキネコ
起訴	キソ
神経系	シンケイケイ
金型	カナガタ
紀元前19世紀	キゲンゼンジュウキュウセイキ
紀元前20世紀	キゲンゼンニジュウセイキ
紀元前21世紀	キゲンゼンニジュウイチセイキ
屈折語	クッセツゴ
意識	イシキ
治安維持法	チアンイジホウ
神慈秀明会	シンジシュウメイカイ
飯南郡	イイナングン
多気郡	タキグン
度会郡	ワタライグン
日本の利益団体一覧	ニホンノリエキダンタイイチラン
北牟婁郡	キタムログン
旭川医科大学	アサヒカワイカダイガク
北上川	キタカミガワ
守邦親王	モリクニシンノウ
宗尊親王	ムネタカシンノウ
惟康親王	コレヤスシンノウ
目安箱	メヤスバコ
過年度生	カネンドセイ
石灰石	セッカイセキ
高槻市駅	タカツキシエキ
水無瀬駅	ミナセエキ
大山崎駅	オオヤマザキエキ
長岡天神駅	ナガオカテンジンエキ
西向日駅	ニシムコウエキ
東向日駅	ヒガシムコウエキ
桂駅	カツラエキ
西京極駅	ニシキョウゴクエキ
烏丸駅	カラスマエキ
一宮市	イチノミヤシ
洛西口駅	ラクサイグチエキ
上桂駅	カミカツラエキ
松尾大社駅	マツオタイシャエキ
嵐山駅	アラシヤマエキ
苦楽園口駅	クラクエングチエキ
甲陽園駅	コウヨウエンエキ
豊田市	トヨタシ
山形市	ヤマガタシ
上野市	ウエノシ
武蔵野市	ムサシノシ
郡山市	コオリヤマシ
高知市	コウチシ
比婆郡	ヒバグン
灘区	ナダク
中国方言	チュウゴクホウゲン
六点円	ロクテンエン
島根日日新聞	シマネニチニチシンブン
伊勢新聞	イセシンブン
夕刊三重	ユウカンミエ
六四天安門事件	ロクシテンアンモンジケン
シグナル伝達	サイボウシグナルデンタツ
橋本	ハシモト
刑集	ケイシュウ
栃木新聞	トチギシンブン
埼玉新聞	サイタマシンブン
千葉日報	チバニッポウ
量子暗号	リョウシアンゴウ
大東亜帝国	ダイトウアテイコク
振替休日	フリカエキュウジツ
国技	コクギ
大朝駅	オオアサエキ
焼津市	ヤイヅシ
藤枝市	フジエダシ
新羽駅	ニッパエキ
神産み	カミウミ
池ノ上駅	イケノウエエキ
界磁添加励磁制御	カイジテンカレイジセイギョ
朝鮮学校	チョウセンガッコウ
日本人学校	ニホンジンガッコウ
債務	サイム
抵抗制御	テイコウセイギョ
黒雲母	クロウンモ
長石	チョウセキ
沖縄社会大衆党	オキナワシャカイタイシュウトウ
大阪空港駅	オオサカクウコウエキ
柴原阪大前駅	シバハラハンダイマエエキ
少路駅	ショウジエキ
宇野辺駅	ウノベエキ
沢良宜駅	サワラギエキ
皮翼目	ヒヨクモク
門真市駅	カドマシエキ
公園東口駅	コウエンヒガシグチエキ
阪大病院前駅	ハンダイビョウインマエエキ
武蔵中原駅	ムサシナカハラエキ
武蔵新城駅	ムサシシンジョウエキ
奏法	ソウホウ
網膜	モウマク
中高一貫教育	チュウコウイッカンキョウイク
私立学校	シリツガッコウ
青森公立大学	アオモリコウリツダイガク
外国人学校	ガイコクジンガッコウ
確定申告	カクテイシンコク
四原因説	シゲンインセツ
動物行動学	ドウブツコウドウガク
生物物理学	セイブツブツリガク
微生物学	ビセイブツガク
分類学	ブンルイガク
構造生物学	コウゾウセイブツガク
好熱菌	コウネツキン
弱音器	ジャクオンキ
公立大学	コウリツダイガク
低圧バンキング方式	テイアツバンキングホウシキ
亡霊	ボウレイ
神学者の一覧	シンガクシャノイチラン
造岩鉱物	ゾウガンコウブツ
明道館	メイドウカン
冷凍食品	レイトウショクヒン
天命	テンメイ
盆地	ボンチ
日本の官制	ニホンノカンセイ
微生物	ビセイブツ
広島空港	ヒロシマクウコウ
岡山空港	オカヤマクウコウ
洒落本	シャレボン
滑稽本	コッケイボン
人情本	ニンジョウボン
談義本	ダンギボン
草双紙	クサゾウシ
霊長目	レイチョウモク
暴力	ボウリョク
恐喝罪	キョウカツザイ
条例	ジョウレイ
走虎	ソウコ
走蛇	ソウジャ
走狗	ソウク
飛燕	ヒエン
欽宗	キンソウ
絹延橋駅	キヌノベバシエキ
滝山駅	タキヤマエキ
鼓滝駅	ツヅミガタキエキ
千歳市	チトセシ
万博記念公園	バンパクキネンコウエン
産業再生機構	サンギョウサイセイキコウ
笠沙町	カササチョウ
秋田魁新報	アキタサキガケシンポウ
世俗主義	セゾクシュギ
普天間飛行場	フテンマヒコウジョウ
明治神宮野球大会	メイジジングウヤキュウタイカイ
鳴子町	ナルコチョウ
鳴子	ナルコ
北朝鮮核問題	キタチョウセンカクモンダイ
無重量状態	ムジュウリョウジョウタイ
放送事業者	ホウソウジギョウシャ
曲鼻亜目	キョクビアモク
一の鳥居駅	イチノトリイエキ
畦野駅	ウネノエキ
笹部駅	ササベエキ
大阪市中央公会堂	オオサカシチュウオウコウカイドウ
瑞穂	ミズホ
仲多度郡	ナカタドグン
意思表示	イシヒョウジ
簿記	ボキ
悪	アク
一党優位政党制	イットウユウイセイトウセイ
知覚	チカク
大阪市立東洋陶磁美術館	オオサカシリツトウヨウトウジビジュツカン
大阪城天守閣	オオサカジョウテンシュカク
好塩菌	コウエンキン
大阪市立美術館	オオサカシリツビジュツカン
中性点接地方式	チュウセイテンセッチホウシキ
大阪府立中之島図書館	オオサカフリツナカノシマトショカン
誘導体	ユウドウタイ
国立文楽劇場	コクリツブンラクゲキジョウ
活量	カツリョウ
布袋駅	ホテイエキ
川端康成文学賞	カワバタヤスナリブンガクショウ
有楽町	ユウラクチョウ
遊星爆弾	ユウセイバクダン
垓下の戦い	ガイカノタタカイ
銕橋	クロガネバシ
大通公園	オオドオリコウエン
青図	アオズ
文楽	ブンラク
圧接	アッセツ
新京阪鉄道	シンケイハンテツドウ
藩鎮	ハンチン
千林駅	センバヤシエキ
滝井駅	タキイエキ
西三荘駅	ニシサンソウエキ
古川橋駅	フルカワバシエキ
赤泊村	アカドマリムラ
下井草駅	シモイグサエキ
神学者	シンガクシャ
震央	シンオウ
流山市	ナガレヤマシ
南多摩郡	ミナミタマグン
長期信用銀行	チョウキシンヨウギンコウ
北多摩郡	キタタマグン
八王子市立の小学校一覧	ハチオウジシリツノショウガッコウイチラン
医用接地	イヨウセッチ
借室電気室	シャクシツデンキシツ
伝達関数法	デンタツカンスウホウ
くる梨	クルリ
地蔵菩薩	ジゾウボサツ
三条京阪駅	サンジョウケイハンエキ
岩国刑務所	イワクニケイムショ
伊那北駅	イナキタエキ
寝屋川市駅	ネヤガワシエキ
光善寺駅	コウゼンジエキ
本予備線方式	ホンヨビセンホウシキ
御殿山駅	ゴテンヤマエキ
交流送電	コウリュウソウデン
仲町台駅	ナカマチダイエキ
三ツ沢上町駅	ミツザワカミチョウエキ
片倉町駅	カタクラチョウエキ
連合赤軍	レンゴウセキグン
水原町	スイバラマチ
鎌取駅	カマトリエキ
島牧郡	シママキグン
寿都郡	スッツグン
磯谷郡	イソヤグン
岩内郡	イワナイグン
古宇郡	フルウグン
積丹郡	シャコタングン
古平郡	フルビラグン
余市郡	ヨイチグン
誉田駅	ホンダエキ
異性装	イセイソウ
唯物史観	ユイブツシカン
八王の乱	ハチオウノラン
小山町	オヤマチョウ
大網駅	オオアミエキ
男装	ダンソウ
女装	ジョソウ
南蒲原郡	ミナミカンバラグン
田中上奏文	タナカジョウソウブン
本納駅	ホンノウエキ
古志郡	コシグン
中魚沼郡	ナカウオヌマグン
新茂原駅	シンモバラエキ
刈羽郡	カリワグン
北蒲原郡	キタカンバラグン
中蒲原郡	ナカカンバラグン
八積駅	ヤツミエキ
西蒲原郡	ニシカンバラグン
東蒲原郡	ヒガシカンバラグン
岩船郡	イワフネグン
上総一ノ宮駅	カズサイチノミヤエキ
芳賀郡	ハガグン
乳酸脱水素酵素	ニュウサンダッスイソコウソ
上水内郡	カミミノチグン
下水内郡	シモミノチグン
上高井郡	カミタカイグン
下高井郡	シモタカイグン
更級郡	サラシナグン
埴科郡	ハニシナグン
小県郡	チイサガタグン
東筑摩郡	ヒガシチクマグン
木曽郡	キソグン
北安曇郡	キタアヅミグン
諏訪郡	スワグン
上伊那郡	カミイナグン
東茨城郡	ヒガシイバラキグン
西茨城郡	ニシイバラキグン
那珂郡	ナカグン
久慈郡	クジグン
多賀郡	タガグン
稲敷郡	イナシキグン
新治郡	ニイハリグン
筑波郡	ツクバグン
真壁郡	マカベグン
結城郡	ユウキグン
北相馬郡	キタソウマグン
羽咋郡	ハクイグン
鹿島郡	カシマグン
鳳至郡	フゲシグン
珠洲郡	スズグン
足羽郡	アスワグン
吉田郡	ヨシダグン
坂井郡	サカイグン
今立郡	イマダテグン
南条郡	ナンジョウグン
丹生郡	ニュウグン
遠敷郡	オニュウグン
大飯郡	オオイグン
万願寺駅	マンガンジエキ
加東郡	カトウグン
長野日報	ナガノニッポウ
飾磨郡	シカマグン
神崎郡	カンザキグン
宍粟郡	シソウグン
出石郡	イズシグン
美方郡	ミカタグン
朝来郡	アサゴグン
氷上郡	ヒカミグン
津名郡	ツナグン
三原郡	ミハラグン
磯城郡	シキグン
宇陀郡	ウダグン
高市郡	タカイチグン
伊都郡	イトグン
御調郡	ミツギグン
世羅郡	セラグン
沼隈郡	ヌマクマグン
深安郡	フカヤスグン
神石郡	ジンセキグン
甲奴郡	コウヌグン
富山駅	トヤマエキ
庚申信仰	コウシンシンコウ
朝鮮人民軍	チョウセンジンミングン
加賀郡	カガグン
文壇	ブンダン
電波監理委員会	デンパカンリイインカイ
羽茂町	ハモチマチ
大司教	ダイシキョウ
酒折駅	サカオリエキ
佐幕	サバク
七里ヶ浜駅	シチリガハマエキ
京都守護職	キョウトシュゴショク
香椎宮	カシイグウ
富士山有料道路	フジサンユウリョウドウロ
京都見廻組	キョウトミマワリグミ
河口湖大橋	カワグチコオオハシ
渡良瀬川	ワタラセガワ
能	ノウ
三潴町	ミヅママチ
試衛館	シエイカン
田畑駅	タバタエキ
北殿駅	キタトノエキ
大西洋横断飛行	タイセイヨウオウダンヒコウ
木ノ下駅	キノシタエキ
沢渡駅	サワンドエキ
赤木駅	アカギエキ
大田切駅	オオタギリエキ
宮木駅	ミヤキエキ
甲州街道駅	コウシュウカイドウエキ
柴崎体育館駅	シバサキタイイクカンエキ
全学共闘会議	ゼンガクキョウトウカイギ
伊那新町駅	イナシンマチエキ
沢駅	サワエキ
宇野気駅	ウノケエキ
甲陽鎮撫隊	コウヨウチンブタイ
脱藩	ダッパン
新選組顛末記	シンセングミテンマツキ
紀元前230年	キゲンゼンニヒャクサンジュウネン
新穂村	ニイボムラ
太平天国の乱	タイヘイテンゴクノラン
妖怪	ヨウカイ
玖珂郡	クガグン
吉敷郡	ヨシキグン
大津郡	オオツグン
阿武郡	アブグン
名西郡	ミョウザイグン
越境合併	エッキョウガッペイ
阿波郡	アワグン
三好郡	ミヨシグン
小豆郡	ショウズグン
木田郡	キタグン
香川郡	カガワグン
綾歌郡	アヤウタグン
温泉郡	オンセングン
上浮穴郡	カミウケナグン
伊那福岡駅	イナフクオカエキ
小町屋駅	コマチヤエキ
宮田駅	ミヤダエキ
伊那松島駅	イナマツシマエキ
辰野駅	タツノエキ
根岸駅	ネギシエキ
駒ケ根駅	コマガネエキ
貸金業	カシキンギョウ
高岡駅	タカオカエキ
田切駅	タギリエキ
飯島駅	イイジマエキ
伊那本郷駅	イナホンゴウエキ
七久保駅	ナナクボエキ
御陵衛士	ゴリョウエジ
源氏物語の登場人物	ゲンジモノガタリノトウジョウジンブツ
高遠原駅	タカトオバラエキ
伊那田島駅	イナタジマエキ
魚津市	ウオヅシ
黒部市	クロベシ
装飾音	ソウショクオン
氷見市	ヒミシ
宮家一覧	ミヤケイチラン
油小路事件	アブラノコウジジケン
能楽	ノウガク
教皇不可謬説	キョウコウフカビュウセツ
蒸気圧	ヘイコウジョウキアツ
友部駅	トモベエキ
楕円曲線	ダエンキョクセン
真岡市	モオカシ
君津市	キミツシ
就学義務猶予免除者等の中学校卒業程度認定試験	シュウガクギムユウヨメンジョシャトウノチュウガッコウソツギョウテイドニンテイシケン
中検	チュウケン
赤穂市	アコウシ
艦上攻撃機	カンジョウコウゲキキ
新潟日報	ニイガタニッポウ
白尾料金所	シロオリョウキンジョ
発話	ハツワ
長州五傑	チョウシュウゴケツ
旭川駅	アサヒカワエキ
大目付	オオメツケ
上片桐駅	カミカタギリエキ
伊那大島駅	イナオオシマエキ
山吹駅	ヤマブキエキ
下平駅	シモダイラエキ
市田駅	イチダエキ
すぎ丸	スギマル
変電設備	ヘンデンセツビ
白河藩	シラカワハン
奨学金	ショウガクキン
天王台駅	テンノウダイエキ
伊予松山藩	イヨマツヤマハン
桑名藩	クワナハン
京都所司代	キョウトショシダイ
静岡県立藤枝東高等学校	シズオカケンリツフジエダヒガシコウトウガッコウ
羽幌線	ハボロセン
学校法人桃山学院	ガッコウホウジンモモヤマガクイン
国分寺	コクブンジ
公妾	コウショウ
大歩危駅	オオボケエキ
南平駅	ミナミダイラエキ
百草園駅	モグサエンエキ
繁藤駅	シゲトウエキ
平山城址公園駅	ヒラヤマジョウシコウエンエキ
新改駅	シンガイエキ
解脱会	ゲダツカイ
湧網線	ユウモウセン
測地学	ソクチガク
豊玉姫神社	トヨタマヒメジンジャ
一分子生物学	イチブンシセイブツガク
無原罪の御宿り	ムゲンザイノオンヤドリ
男体山	ナンタイサン
水の郷百選	ミズノサトヒャクセン
六合駅	ロクゴウエキ
両津市	リョウツシ
牧野駅	マキノエキ
樟葉駅	クズハエキ
金谷駅	カナヤエキ
親征	シンセイ
狭間駅	ハザマエキ
新しい歴史教科書をつくる会	イッパンシャダンホウジンアタラシイレキシキョウカショヲツクルカイ
京王片倉駅	ケイオウカタクラエキ
義	ギ
義人	ギジン
新徴組	シンチョウグミ
康熙帝	コウキテイ
代田橋駅	ダイタバシエキ
桜上水駅	サクラジョウスイエキ
八幡山駅	ハチマンヤマエキ
公武合体	コウブガッタイ
大脳皮質	ダイノウヒシツ
芦花公園駅	ロカコウエンエキ
千歳烏山駅	チトセカラスヤマエキ
仙川駅	センガワエキ
つつじヶ丘駅	ツツジガオカエキ
布田駅	フダエキ
原当麻駅	ハラタイマエキ
下溝駅	シモミゾエキ
架空	カクウ
稲城長沼駅	イナギナガヌマエキ
程久保駅	ホドクボエキ
東松原駅	ヒガシマツバラエキ
永福町駅	エイフクチョウエキ
西永福駅	ニシエイフクエキ
浜田山駅	ハマダヤマエキ
三鷹台駅	ミタカダイエキ
井の頭公園駅	イノカシラコウエンエキ
相模湖駅	サガミコエキ
藤野駅	フジノエキ
士幌線	シホロセン
勇払	ユウフツ
位相	イソウ
押し付け憲法論	オシツケケンポウロン
陸上競技場	リクジョウキョウギジョウ
一日乗車券	イチニチジョウシャケン
歯学	シガク
体細胞分裂	タイサイボウブンレツ
付加反応	フカハンノウ
座間駅	ザマエキ
間宮海峡	マミヤカイキョウ
広尾線	ヒロオセン
瀬棚線	セタナセン
旅人算	タビビトザン
生瀬駅	ナマゼエキ
西宮名塩駅	ニシノミヤナジオエキ
道場駅	ドウジョウエキ
幕臣	バクシン
武田尾駅	タケダオエキ
広鼻小目	コウビショウモク
田楽	デンガク
投機	トウキ
夕張市	ユウバリシ
駒澤大学	コマザワダイガク
南山大学	ナンザンダイガク
維新	イシン
大学通信教育	ダイガクツウシンキョウイク
北九州市立大学	キタキュウシュウシリツダイガク
大阪外国語大学	オオサカガイコクゴダイガク
京都工芸繊維大学	キョウトコウゲイセンイダイガク
手宮線	テミヤセン
消費者余剰	ショウヒシャヨジョウ
効用	コウヨウ
利潤最大化	リジュンサイダイカ
機会費用	キカイヒヨウ
中学受験	チュウガクジュケン
自由財	ジユウザイ
限界効用	ゲンカイコウヨウ
大平駅	オオダイエキ
弾力性	ダンリョクセイ
津軽二股駅	ツガルフタマタエキ
選好	センコウ
大川平駅	オオカワダイエキ
今別駅	イマベツエキ
津軽浜名駅	ツガルハマナエキ
近代経済学	キンダイケイザイガク
三厩駅	ミンマヤエキ
費用曲線	ヒヨウキョクセン
津軽大沢駅	ツガルオオサワエキ
五次方程式	ゴジホウテイシキ
松木平駅	マツキタイエキ
小栗山駅	コグリヤマエキ
千年駅	チトセエキ
聖愛中高前駅	セイアイチュウコウマエエキ
会計学	カイケイガク
弘前学院大前駅	ヒロサキガクインダイマエエキ
弘高下駅	ヒロコウシタエキ
中央弘前駅	チュウオウヒロサキエキ
義塾高校前駅	ギジュクコウコウマエエキ
北朝霞駅	キタアサカエキ
宿川原駅	シュクガワラエキ
鯖石駅	サバイシエキ
国電	コクデン
南太平洋海戦	ミナミタイヘイヨウカイセン
偽書	ギショ
柏農高校前駅	ハクノウコウコウマエエキ
津軽尾上駅	ツガルオノエエキ
尾上高校前駅	オノエコウコウマエエキ
境松駅	サカイマツエキ
大東市	ダイトウシ
合成洗剤	ゴウセイセンザイ
忍ケ丘駅	シノブガオカエキ
古史古伝	コシコデン
臨界点	リンカイテン
催眠	サイミン
催眠療法	サイミンリョウホウ
陸繋島	リクケイトウ
忍野村	オシノムラ
発祥	ハッショウ
特別支援学級	トクベツシエンガッキュウ
小学校受験	ショウガッコウジュケン
不平等条約	フビョウドウジョウヤク
高校受験	コウコウジュケン
芦屋町	アシヤマチ
玉村町	タマムラマチ
司法警察職員	シホウケイサツショクイン
富内線	トミウチセン
熱圏	ネツケン
狛江駅	コマエエキ
電気工作物	デンキコウサクブツ
近畿大阪銀行	キンキオオサカギンコウ
学門駅	ガクモンエキ
藤枝駅	フジエダエキ
楽典	ガクテン
倶知安駅	クッチャンエキ
加西市	カサイシ
白糠線	シラヌカセン
大陸棚	タイリクダナ
新金谷駅	シンカナヤエキ
心霊現象研究協会	シンレイゲンショウケンキュウキョウカイ
公主	コウシュ
川根温泉笹間渡駅	カワネオンセンササマドエキ
福音寺駅	フクオンジエキ
茅野市	チノシ
心霊現象研究	シンレイゲンショウケンキュウ
大津事件	オオツジケン
心霊現象	シンレイゲンショウ
七種競技	ナナシュキョウギ
京都議定書	キコウヘンドウニカンスルコクサイレンゴウワクグミジョウヤクノキョウトギテイショ
文法	ブンポウ
遠州大橋	エンシュウオオハシ
競歩	キョウホ
予言	ヨゲン
尻手駅	シッテエキ
特定都区市内	トクテイトクシナイ
幌平橋駅	ホロヒラバシエキ
銚子電気鉄道線	チョウシデンキテツドウセン
新松田駅	シンマツダエキ
愛甲石田駅	アイコウイシダエキ
伊勢原駅	イセハラエキ
原級留置	ゲンキュウリュウチ
文學界新人賞	ブンガクカイシンジンショウ
あさひ銀行	アサヒギンコウ
大和銀行	ダイワギンコウ
四駿四狗	シシュンシク
埼玉銀行	サイタマギンコウ
湯の里知内信号場	ユノサトシリウチシンゴウジョウ
協和銀行	キョウワギンコウ
貯蓄銀行	チョチクギンコウ
南越谷駅	ミナミコシガヤエキ
規模の経済	キボノケイザイ
例外状態	レイガイジョウタイ
様態論	ヨウタイロン
土佐勤王党	トサキンノウトウ
高祖	コウソ
すばる文学賞	スバルブンガクショウ
神戸銀行	コウベギンコウ
太陽銀行	タイヨウギンコウ
太陽神戸銀行	タイヨウコウベギンコウ
わかしお銀行	ワカシオギンコウ
小説すばる新人賞	ショウセツスバルシンジンショウ
東京銀行	トウキョウギンコウ
三和銀行	サンワギンコウ
東海銀行	トウカイギンコウ
名取市	ナトリシ
日本長期信用銀行	ニッポンチョウキシンヨウギンコウ
森松駅	モリマツエキ
柏尾川	カシオガワ
宗教学者	シュウキョウガクシャ
媒質	バイシツ
岩沼市	イワヌマシ
角川小説賞	カドカワショウセツショウ
角田市	カクダシ
業務核都市	ギョウムカクトシ
咬耗症	コウモウショウ
世界真光文明教団	セカイマヒカリブンメイキョウダン
回転体	カイテンタイ
崇教眞光	スウキョウマヒカリ
真光系諸教団	マヒカリケイショキョウダン
海老名市	エビナシ
日野宿	ヒノジュク
北久米駅	キタクメエキ
久米駅	クメエキ
評価損益	ヒョウカソンエキ
並列計算	ヘイレツケイサン
爆笑問題	バクショウモンダイ
在日認定	ザイニチニンテイ
和泉多摩川駅	イズミタマガワエキ
喜多見駅	キタミエキ
鳥取銀行	トットリギンコウ
第一銀行	ダイイチギンコウ
日本勧業銀行	ニホンカンギョウギンコウ
帝国銀行	テイコクギンコウ
皇帝礼拝	コウテイレイハイ
戯画	ギガ
北日本新聞	キタニッポンシンブン
鷹ノ子駅	タカノコエキ
崩御	ホウギョ
田窪駅	タノクボエキ
梅本駅	ウメノモトエキ
牛渕団地前駅	ウシブチダンチマエエキ
公共放送	コウキョウホウソウ
愛大医学部南口駅	アイダイイガクブミナミグチエキ
英国放送協会	エイコクホウソウキョウカイ
酸化物	サンカブツ
少年保護手続	ショウネンホゴテツヅキ
紀伝体	キデンタイ
都道府県の人口一覧	トドウフケンノジンコウイチラン
盲導犬	モウドウケン
修正主義	シュウセイシュギ
座間市	ザマシ
牛渕駅	ウシブチエキ
見奈良駅	ミナラエキ
横河原駅	ヨコガワラエキ
黒住教	クロズミキョウ
教派神道	キョウハシントウ
岩内線	イワナイセン
都市農業公園	アダチクトシノウギョウコウエン
農業公園	ノウギョウコウエン
指	ユビ
万字線	マンジセン
芝公園駅	シバコウエンエキ
白金台駅	シロカネダイエキ
日比谷駅	ヒビヤエキ
朝鮮社会民主党	チョウセンシャカイミンシュトウ
荊州	ケイシュウ
農耕	ノウコウ
相生線	アイオイセン
毘沙門駅	ビシャモンエキ
金木駅	カナギエキ
芦野公園駅	アシノコウエンエキ
川倉駅	カワクラエキ
大沢内駅	オオザワナイエキ
深郷田駅	フコウダエキ
津軽中里駅	ツガルナカサトエキ
天道教青友党	テンドウキョウセイユウトウ
向ヶ丘遊園駅	ムコウガオカユウエンエキ
大牟田駅	オオムタエキ
学生運動	ガクセイウンドウ
半田市	ハンダシ
渚滑線	ショコツセン
市坪駅	イチツボエキ
下野新聞	シモツケシンブン
福島民報	フクシマミンポウ
富山新聞	トヤマシンブン
最低速度	サイテイソクド
阿波踊り	アワオドリ
健訟	ケンショウ
京田辺市	キョウタナベシ
峡谷	キョウコク
見晴台学園	ミハラシダイガクエン
ミルマンの定理	ミルマンノテイリ
政策学部	セイサクガクブ
姫路獨協大学	ヒメジドッキョウダイガク
教職課程	キョウショクカテイ
北伊予駅	キタイヨエキ
伊予横田駅	イヨヨコタエキ
鳥ノ木駅	トリノキエキ
伊予市駅	イヨシエキ
高尾山	タカオサン
総合型選抜	ソウゴウガタセンバツ
安食駅	アジキエキ
木古内駅	キコナイエキ
東浪見駅	トラミエキ
太東駅	タイトウエキ
長者町駅	チョウジャマチエキ
三門駅	ミカドエキ
飽和攻撃	ホウワコウゲキ
浪花駅	ナミハナエキ
前衛美術	ゼンエイビジュツ
御宿駅	オンジュクエキ
勝浦駅	カツウラエキ
鵜原駅	ウバラエキ
上総興津駅	カズサオキツエキ
萱町六丁目停留場	カヤマチロクチョウメテイリュウジョウ
二等辺三角形	ニトウヘンサンカクケイ
善悪二元論	ゼンアクニゲンロン
長泉なめり駅	ナガイズミナメリエキ
安房小湊駅	アワコミナトエキ
鹿島鉄道線	カシマテツドウセン
安房天津駅	アワアマツエキ
安房鴨川駅	アワカモガワエキ
現役	ゲンエキ
広尾駅	ヒロオエキ
小伝馬町駅	コデンマチョウエキ
築地駅	ツキジエキ
神谷町駅	カミヤチョウエキ
計量経済学	ケイリョウケイザイガク
淀川電車区	ヨドガワデンシャク
美幸線	ビコウセン
厘	リン
梅田貨物線	ウメダカモツセン
北方貨物線	ホッポウカモツセン
六本木駅	ロッポンギエキ
下総松崎駅	シモウサマンザキエキ
大井川	オオイガワ
八戸ノ里駅	ヤエノサトエキ
日立デジタル平凡社	ヒタチデジタルヘイボンシャ
介護	カイゴ
麻布十番駅	アザブジュウバンエキ
赤羽橋駅	アカバネバシエキ
普遍論争	フヘンロンソウ
学校法人同志社	ガッコウホウジンドウシシャ
今出川駅	イマデガワエキ
法人税	ホウジンゼイ
六本木一丁目駅	ロッポンギイッチョウメエキ
外苑前駅	ガイエンマエエキ
歌枕	ウタマクラ
代々木公園駅	ヨヨギコウエンエキ
経済学部	ケイザイガクブ
国際河川	コクサイカセン
宣徳帝	セントクテイ
多摩郡	タマグン
当理流	トウリリュウ
加茂郡	カモグン
豊田郡	トヨタグン
明治神宮前駅	メイジジングウマエエキ
東海道貨物線	トウカイドウカモツセン
国会議事堂前駅	コッカイギジドウマエエキ
騎士修道会	キシシュウドウカイ
竹橋駅	タケバシエキ
木屋町停留場	キヤチョウテイリュウジョウ
本町五丁目停留場	ホンマチゴチョウメテイリュウジョウ
本町四丁目停留場	ホンマチヨンチョウメテイリュウジョウ
火葬	カソウ
鳥葬	チョウソウ
新三田駅	シンサンダエキ
相野駅	アイノエキ
藍本駅	アイモトエキ
北茅ケ崎駅	キタチガサキエキ
阪和貨物線	ハンワカモツセン
廟号	ビョウゴウ
義務	ギム
人間国宝	ニンゲンコクホウ
反戦運動	ハンセンウンドウ
自由落下	ジユウラッカ
性的指向	セイテキシコウ
追手門学院大学	オウテモンガクインダイガク
福岡都市圏	フクオカトシケン
博多	ハカタ
伝統宗教	デントウシュウキョウ
南矢代駅	ミナミヤシロエキ
篠山口駅	ササヤマグチエキ
丹波大山駅	タンバオオヤマエキ
下滝駅	シモタキエキ
静岡理工科大学	シズオカリコウカダイガク
博多弁	ハカタベン
連続体濃度	レンゾクタイノウド
発達検査	ハッタツケンサ
小牛田駅	コゴタエキ
槻木駅	ツキノキエキ
東我孫子駅	ヒガシアビコエキ
誹謗中傷	ヒボウチュウショウ
吉川市	ヨシカワシ
演技	エンギ
岩手日日	イワテニチニチ
北辰一刀流	ホクシンイットウリュウ
狩猟採集社会	シュリョウサイシュウシャカイ
静電容量	セイデンヨウリョウ
旧制高等学校	キュウセイコウトウガッコウ
三津浜駅	ミツハマエキ
香川駅	カガワエキ
閻魔	エンマ
寒川駅	サムカワエキ
乾燥帯	カンソウタイ
宮山駅	ミヤヤマエキ
大藪春彦賞	オオヤブハルヒコショウ
向井原駅	ムカイバラエキ
来島海峡第三大橋	クルシマカイキョウダイサンオオハシ
貴志川町	キシガワチョウ
妊娠中絶	ニンシンチュウゼツ
反証主義	ハンショウシュギ
松江しんじ湖温泉駅	マツエシンジコオンセンエキ
機関紙	キカンシ
弁護士	ベンゴシ
連歌	レンガ
急行線	キュウコウセン
逸脱酵素	イツダツコウソ
少年院	ショウネンイン
看護理論	カンゴリロン
上毛新聞	ジョウモウシンブン
霊柩車	レイキュウシャ
館腰駅	タテコシエキ
名取駅	ナトリエキ
有壁駅	アリカベエキ
清水原駅	シミズハラエキ
花泉駅	ハナイズミエキ
油島駅	ユシマエキ
石越駅	イシコシエキ
永山駅	ナガヤマエキ
銭函駅	ゼニバコエキ
日目	ニチモク
夜想曲	ヤソウキョク
序曲	ジョキョク
間奏曲	カンソウキョク
漢文	カンブン
融解	ユウカイ
漫画原稿を守る会	マンガゲンコウヲマモルカイ
新得駅	シントクエキ
生体膜	セイタイマク
玉川上水	タマガワジョウスイ
景泰帝	ケイタイテイ
村山市	ムラヤマシ
浮世草子	ウキヨゾウシ
欽定訳聖書	キンテイヤクセイショ
旭川四条駅	アサヒカワヨジョウエキ
朝の歳時記	アサノサイジキ
梅ケ沢駅	ウメガサワエキ
瀬峰駅	セミネエキ
田尻駅	タジリエキ
東仙台駅	ヒガシセンダイエキ
岩切駅	イワキリエキ
幽霊	ユウレイ
浅野川	アサノガワ
成化帝	セイカテイ
倉月荘	クラツキノショウ
東中野駅	ヒガシナカノエキ
岩槻市	イワツキシ
正信会	ショウシンカイ
弘治帝	コウチテイ
内灘砂丘	ウチナダサキュウ
小金井駅	コガネイエキ
本町三丁目停留場	ホンマチサンチョウメテイリュウジョウ
西堀端停留場	ニシホリバタテイリュウジョウ
大分市営陸上競技場	オオイタシエイリクジョウキョウギジョウ
野内駅	ノナイエキ
浅虫温泉駅	アサムシオンセンエキ
新夕張駅	シンユウバリエキ
桑園駅	ソウエンエキ
塾	ジュク
貫徹力	カンテツリョク
地下鉄赤塚駅	チカテツアカツカエキ
質屋	シチヤ
下赤塚駅	シモアカツカエキ
南堀端停留場	ミナミホリバタテイリュウジョウ
最上川	モガミガワ
終端抵抗	シュウタンテイコウ
老視	ロウシ
春日部市	カスカベシ
久喜市	クキシ
幸手市	サッテシ
無線局	ムセンキョク
嘉例川駅	カレイガワエキ
正徳帝	セイトクテイ
貨物線	カモツセン
高松築港駅	タカマツチッコウエキ
黒磯駅	クロイソエキ
温室効果	オンシツコウカ
少林寺拳法	ショウリンジケンポウ
牧畜	ボクチク
興浜北線	コウヒンホクセン
興浜南線	コウヒンナンセン
美薗中央公園駅	ミソノチュウオウコウエンエキ
有馬温泉	アリマオンセン
嘉靖帝	カセイテイ
連珠	レンジュ
将棋盤	ショウギバン
中野栄駅	ナカノサカエエキ
舞台美術	ブタイビジュツ
演繹	エンエキ
帰納	キノウ
松山町駅	マツヤママチエキ
鹿島台駅	カシマダイエキ
品井沼駅	シナイヌマエキ
清水沢駅	シミズサワエキ
富良野駅	フラノエキ
岩見沢駅	イワミザワエキ
上牧町	カンマキチョウ
松島駅	マツシマエキ
雨上がり決死隊	アメアガリケッシタイ
大街道停留場	オオカイドウテイリュウジョウ
今治精華高等学校	イマバリセイカコウトウガッコウ
胴上げ	ドウアゲ
消化試合	ショウカジアイ
橿原神宮前駅	カシハラジングウマエエキ
芸人	ゲイニン
東灘区	ヒガシナダク
山健組	ヤマケングミ
隆慶帝	リュウケイテイ
泰昌帝	タイショウテイ
仮名草子	カナゾウシ
天人師	テンニンシ
北浦駅	キタウラエキ
陸前谷地駅	リクゼンヤチエキ
白河駅	シラカワエキ
さいたま新都心	サイタマシントシン
天啓帝	テンケイテイ
輪王寺	リンノウジ
核分裂反応	カクブンレツハンノウ
當麻町	タイマチョウ
海南市	カイナンシ
燃料噴射装置	ネンリョウフンシャソウチ
清水一家	シミズイッカ
社会福祉士	シャカイフクシシ
健竜会	ケンリュウカイ
勝山町停留場	カツヤマチョウテイリュウジョウ
警察署前停留場	ケイサツショマエテイリュウジョウ
上一万停留場	カミイチマンテイリュウジョウ
南町停留場	ミナミマチテイリュウジョウ
道後公園停留場	ドウゴコウエンテイリュウジョウ
高城町駅	タカギマチエキ
師範学校	シハンガッコウ
都内	トナイ
陸前山王駅	リクゼンサンノウエキ
国府多賀城駅	コクフタガジョウエキ
鹿児島放送	カゴシマホウソウ
藻岩山	モイワヤマ
西平内駅	ニシヒラナイエキ
小湊駅	コミナトエキ
清水川駅	シミズガワエキ
狩場沢駅	カリバサワエキ
野辺地駅	ノヘジエキ
葛岡駅	クズオカエキ
千曳駅	チビキエキ
陸前落合駅	リクゼンオチアイエキ
乙供駅	オットモエキ
上北町駅	カミキタチョウエキ
小川原駅	コガワラエキ
阿下喜駅	アゲキエキ
南松浦郡	ミナミマツウラグン
北高来郡	キタタカキグン
南高来郡	ミナミタカキグン
北松浦郡	キタマツウラグン
宇土郡	ウトグン
下益城郡	シモマシキグン
玉名郡	タマナグン
鹿本郡	カモトグン
利府駅	リフエキ
上益城郡	カミマシキグン
八代郡	ヤツシログン
白蓮教	ビャクレンキョウ
葦北郡	アシキタグン
天草郡	アマクサグン
西国東郡	ニシクニサキグン
東国東郡	ヒガシクニサキグン
速見郡	ハヤミグン
大分郡	オオイタグン
北海部郡	キタアマベグン
南海部郡	ミナミアマベグン
直入郡	ナオイリグン
新利府駅	シンリフエキ
玖珠郡	クスグン
日田郡	ヒタグン
下毛郡	シモゲグン
宇佐郡	ウサグン
南那珂郡	ミナミナカグン
北諸県郡	キタモロカタグン
東諸県郡	ヒガシモロカタグン
児湯郡	コユグン
東臼杵郡	ヒガシウスキグン
西臼杵郡	ニシウスキグン
宇摩郡	ウマグン
越智郡	オチグン
周桑郡	シュウソウグン
東宇和郡	ヒガシウワグン
喜多郡	キタグン
西宇和郡	ニシウワグン
北宇和郡	キタウワグン
南宇和郡	ミナミウワグン
土佐郡	トサグン
吾川郡	アガワグン
幡多郡	ハタグン
実効値	ジッコウチ
酸ヶ湯	スカユ
大口市	オオクチシ
東北沢駅	ヒガシキタザワエキ
新柴又駅	シンシバマタエキ
平和通一丁目停留場	ヘイワドオリイッチョウメテイリュウジョウ
赤十字病院前停留場	セキジュウジビョウインマエテイリュウジョウ
鉄砲町停留場	テッポウチョウテイリュウジョウ
清水町停留場	シミズマチテイリュウジョウ
吉本印天然素材	ヨシモトジルシテンネンソザイ
向山駅	ムカイヤマエキ
下田駅	シモダエキ
陸奥市川駅	ムツイチカワエキ
極楽とんぼ	ゴクラクトンボ
鳥居	トリイ
柱	ハシラ
歌謡曲	カヨウキョク
牛魔王	ギュウマオウ
松山港	マツヤマコウ
中書令	チュウショレイ
高砂町停留場	タカサゴチョウテイリュウジョウ
港山駅	ミナトヤマエキ
西衣山駅	ニシキヌヤマエキ
山西駅	ヤマニシエキ
衣山駅	キヌヤマエキ
長谷寺	ハセデラ
原人	ゲンジン
相互銀行	ソウゴギンコウ
筒石駅	ツツイシエキ
所得税	ショトクゼイ
塩辛	シオカラ
外丙	ガイヘイ
太甲	タイコウ
沃丁	ヨクテイ
太庚	タイコウ
太康	タイコウ
大森屋	オオモリヤ
梁川藩	ヤナガワハン
天理駅	テンリエキ
陸前浜田駅	リクゼンハマダエキ
大秦寺	ダイシンジ
北海油田	ホッカイユデン
杭基礎	クイキソ
三津駅	ミツエキ
六朝	リクチョウ
後生掛温泉	ゴショウガケオンセン
高鷲村	タカスムラ
明宝村	メイホウムラ
和良村	ワラムラ
武将	ブショウ
塩原温泉郷	シオバラオンセンキョウ
七星剣	シチセイケン
涼州	リョウシュウ
丙子椒林剣	ヘイシショウリンケン
那須温泉郷	ナスオンセンキョウ
七塚町	ナナツカマチ
宇ノ気町	ウノケマチ
金津町	カナヅチョウ
安岐町	アキマチ
芦原町	アワラチョウ
美土里町	ミドリチョウ
高宮町	タカミヤチョウ
甲田町	コウダチョウ
向原町	ムカイハラチョウ
郷ノ浦町	ゴウノウラチョウ
芦辺町	アシベチョウ
石田町	イシダチョウ
下県郡	シモアガタグン
厳原町	イヅハラマチ
美津島町	ミツシマチョウ
豊玉町	トヨタマチョウ
上県郡	カミアガタグン
峰町	ミネチョウ
上県町	カミアガタチョウ
上対馬町	カミツシマチョウ
内閣情報調査室	ナイカクジョウホウチョウサシツ
劇団四季	ゲキダンシキ
天丼	テンドン
八郷町	ヤサトマチ
組合	クミアイ
中丁	チュウテイ
深礎工法	シンソコウホウ
太戊	タイボ
土居田駅	ドイダエキ
余戸駅	ヨウゴエキ
いなべ市	イナベシ
天皇陛下御即位十年をお祝いする国民祭典	テンノウヘイカゴソクイジュウネンヲオイワイスルコクミンサイテン
鎌田駅	カマタエキ
古泉駅	コイズミエキ
松前駅	マサキエキ
地蔵町駅	ジゾウマチエキ
打撃工法	ダゲキコウホウ
郡中駅	グンチュウエキ
郡中港駅	グンチュウコウエキ
祖丁	ソテイ
北勢町	ホクセイチョウ
大安町	ダイアンチョウ
員弁町	イナベチョウ
沼袋駅	ヌマブクロエキ
上山田町	カミヤマダマチ
赤羽根町	アカバネチョウ
桑折藩	コオリハン
免田町	メンダマチ
洞川温泉	ドロガワオンセン
別子山村	ベッシヤマムラ
裏千家	ウラセンケ
山本山	ヤマモトヤマ
信用組合	シンヨウクミアイ
島津氏	シマヅシ
城崎温泉	キノサキオンセン
中ノ沢温泉	ナカノサワオンセン
絶滅	ゼツメツ
伊豆急下田駅	イズキュウシモダエキ
日光駅	ニッコウエキ
長瀬駅	ナガセエキ
河内小阪駅	カワチコサカエキ
石切駅	イシキリエキ
東武日光駅	トウブニッコウエキ
宇宙飛行士一覧	ウチュウヒコウシイチラン
新八柱駅	シンヤハシラエキ
横浜港	ヨコハマコウ
康熙	コウキ
最多奪三振	サイタダツサンシン
三振	サンシン
最優秀中継ぎ投手	サイユウシュウナカツギトウシュ
相模湖東出口	サガミコヒガシデグチ
鎌倉七口	カマクラナナクチ
切通し	キリドオシ
経営学部	ケイエイガクブ
小乙	ショウイツ
盤庚	バンコウ
河内国分駅	カワチコクブエキ
笑い飯	ワライメシ
尿素	ニョウソ
過酸化水素	カサンカスイソ
出水駅	イズミエキ
こんごう型護衛艦	コンゴウガタゴエイカン
乾隆帝	ケンリュウテイ
旧車會	キュウシャカイ
北陸銀行	ホクリクギンコウ
江戸川駅	エドガワエキ
北海道官設鉄道	ホッカイドウカンセツテツドウ
谷崎潤一郎賞	タニザキジュンイチロウショウ
今年の漢字	コトシノカンジ
帝乙	テイイツ
太丁	タイテイ
北上市	キタカミシ
本鵠沼駅	ホンクゲヌマエキ
芸道論	ゲイドウロン
伊尹	イイン
個人情報	コジンジョウホウ
江別駅	エベツエキ
伽藍	ガラン
人形町駅	ニンギョウチョウエキ
東銀座駅	ヒガシギンザエキ
不安定核	フアンテイカク
北野辺地駅	キタノヘジエキ
有戸駅	アリトエキ
吹越駅	フッコシエキ
有畑駅	アリハタエキ
近川駅	チカガワエキ
赤川駅	アカガワエキ
下北駅	シモキタエキ
大湊駅	オオミナトエキ
文官	ブンカン
函館駅	ハコダテエキ
練馬区立開進第四小学校	ネリマクリツカイシンダイヨンショウガッコウ
北越谷駅	キタコシガヤエキ
執行猶予	シッコウユウヨ
嘉慶帝	カケイテイ
日本の信用金庫一覧	ニホンノシンヨウキンコイチラン
下今市駅	シモイマイチエキ
宮崎大学	ミヤザキダイガク
丸亀城	マルガメジョウ
稲毛区	イナゲク
氷見伏木信用金庫	ヒミフシキシンヨウキンコ
滑川信用金庫	ナメリカワシンヨウキンコ
上市信用金庫	カミイチシンヨウキンコ
本覚	ホンガク
吉川英治文学賞	ヨシカワエイジブンガクショウ
北白川駅	キタシラカワエキ
東白石駅	ヒガシシロイシエキ
越河駅	コスゴウエキ
土浦城	ツチウラジョウ
合理主義	ゴウリシュギ
和田岬駅	ワダミサキエキ
東根市	ヒガシネシ
児童相談所	ジドウソウダンジョ
空燃比	クウネンヒ
伊予和気駅	イヨワケエキ
江戸むらさき	エドムラサキ
開成会	カイセイカイ
切歯	セッシ
横瀬町	ヨコゼマチ
松本清張賞	マツモトセイチョウショウ
吉川英治文学新人賞	ヨシカワエイジブンガクシンジンショウ
同志社女子大学	ドウシシャジョシダイガク
行政区画	ギョウセイクカク
長苗代駅	ナガナワシロエキ
本八戸駅	ホンハチノヘエキ
小中野駅	コナカノエキ
陸奥湊駅	ムツミナトエキ
白銀駅	シロガネエキ
鮫駅	サメエキ
陸奥白浜駅	ムツシラハマエキ
京成曳舟駅	ケイセイヒキフネエキ
八広駅	ヤヒロエキ
四ツ木駅	ヨツギエキ
京成立石駅	ケイセイタテイシエキ
五稜郭駅	ゴリョウカクエキ
規定投球回	キテイトウキュウカイ
東中山駅	ヒガシナカヤマエキ
日本の地名の略表記一覧	ニホンノチメイノリャクヒョウキイチラン
道光帝	ドウコウテイ
成田駅	ナリタエキ
街宣右翼	ガイセンウヨク
皇民党事件	コウミントウジケン
中川	ナカガワ
新羽島駅	シンハシマエキ
旧暦の日付の一覧	キュウレキノヒヅケノイチラン
長老派教会	チョウロウハキョウカイ
神霊教	シンレイキョウ
帯広空港	オビヒロクウコウ
大阪商業大学	オオサカショウギョウダイガク
本所吾妻橋駅	ホンジョアヅマバシエキ
長久手市	ナガクテシ
館林駅	タテバヤシエキ
咸豊帝	カンポウテイ
孤立語	コリツゴ
同治帝	ドウチテイ
伊予若宮信号場	イヨワカミヤシンゴウジョウ
堀江駅	ホリエエキ
根室駅	ネムロエキ
東根室駅	ヒガシネムロエキ
厚床駅	アットコエキ
日比谷公園	ヒビヤコウエン
信教の自由	シンキョウノジユウ
学級新聞	ガッキュウシンブン
狛江市	コマエシ
大阪日日新聞	オオサカニチニチシンブン
本線車道	ホンセンシャドウ
犬歯	ケンシ
泰始	タイシ
本線料金所	ホンセンリョウキンジョ
太熙	タイキ
山本周五郎賞	ヤマモトシュウゴロウショウ
狭鼻小目	キョウビショウモク
整域	セイイキ
譲渡担保	ジョウトタンポ
同志社前駅	ドウシシャマエエキ
京成八幡駅	ケイセイヤワタエキ
螢田駅	ホタルダエキ
富水駅	トミズエキ
栢山駅	カヤマエキ
鳴門市	ナルトシ
富士駅	フジエキ
東静岡駅	ヒガシシズオカエキ
司法統計	シホウトウケイ
宅見組	タクミグミ
理工学部	リコウガクブ
薬害	ヤクガイ
家庭裁判所調査官	カテイサイバンショチョウサカン
交番	コウバン
探偵映画	タンテイエイガ
岡谷市	オカヤシ
清瀬市	キヨセシ
枕投げ	マクラナゲ
光熙	コウキ
勝田台駅	カツタダイエキ
京成佐倉駅	ケイセイサクラエキ
造影剤	ゾウエイザイ
密厳院発露懺悔文	ミツゴンインホツロサンゲノモン
摂津市	セッツシ
楽々はがき	ラクラクハガキ
豪友会	ゴウユウカイ
矢切駅	ヤギリエキ
総大司教	ソウダイシキョウ
固有名詞	コユウメイシ
芝川	シバカワ
十王駅	ジュウオウエキ
日本の農業協同組合一覧	ニッポンノノウギョウキョウドウクミアイイチラン
みな穂農業協同組合	ミナホノウギョウキョウドウクミアイ
天神川駅	テンジンガワエキ
黒部市農業協同組合	クロベシノウギョウキョウドウクミアイ
黒部市信用農業協同組合	クロベシシンヨウノウギョウキョウドウクミアイ
魚津市農業協同組合	ウオヅシノウギョウキョウドウクミアイ
アルプス農業協同組合	アルプスノウギョウキョウドウクミアイ
あおば農業協同組合	アオバノウギョウキョウドウクミアイ
富山市農業協同組合	トヤマシノウギョウキョウドウクミアイ
鵜坂農業協同組合	ウサカノウギョウキョウドウクミアイ
山田村農業協同組合	ヤマダムラノウギョウキョウドウクミアイ
いみず野農業協同組合	イミズノノウギョウキョウドウクミアイ
高岡市農業協同組合	タカオカシノウギョウキョウドウクミアイ
氷見市農業協同組合	ヒミシノウギョウキョウドウクミアイ
となみ野農業協同組合	トナミノノウギョウキョウドウクミアイ
いなば農業協同組合	イナバノウギョウキョウドウクミアイ
福光農業協同組合	フクミツノウギョウキョウドウクミアイ
小鶴新田駅	コヅルシンデンエキ
藤代駅	フジシロエキ
楓信号場	カエデシンゴウジョウ
龍ケ崎市駅	リュウガサキシエキ
香芝駅	カシバエキ
福田町駅	フクダマチエキ
長柄駅	ナガラエキ
新八代駅	シンヤツシロエキ
売血	バイケツ
広田の方法	ヒロタノホウホウ
孤立波	コリツハ
少年犯罪	ショウネンハンザイ
中野新橋駅	ナカノシンバシエキ
新水俣駅	シンミナマタエキ
洗濯板	センタクイタ
京都精華大学	キョウトセイカダイガク
駒澤野球場	コマザワヤキュウジョウ
連邦捜査局	レンポウソウサキョク
築地市場	ツキジシジョウ
日本の電力会社	ニホンノデンリョクガイシャ
総当たり攻撃	ソウアタリコウゲキ
締め上げ暗号分析	シメアゲアンゴウブンセキ
西白井駅	ニシシロイエキ
暫定2車線	ザンテイニシャセン
大政所	オオマンドコロ
日秀尼	ニッシュウニ
上院	ジョウイン
羽村市	ハムラシ
大木町	オオキマチ
福生市	フッサシ
自由民主連合	ジユウミンシュレンゴウ
田沼駅	タヌマエキ
舞鶴市	マイヅルシ
佐野駅	サノエキ
佐野市駅	サノシエキ
加須駅	カゾエキ
木崎駅	キザキエキ
境町駅	サカイマチエキ
三宅支庁	ミヤケシチョウ
八丈支庁	ハチジョウシチョウ
小笠原支庁	オガサワラシチョウ
給食	キュウショク
繊維	センイ
福知山市	フクチヤマシ
尿道	ニョウドウ
仙台市博物館	センダイシハクブツカン
行政警察活動	ギョウセイケイサツカツドウ
司法警察	シホウケイサツ
軍師	グンシ
波動砲	ハドウホウ
尾鷲市	オワセシ
禁演落語	キンエンラクゴ
寒天	カンテン
京都外国語大学	キョウトガイコクゴダイガク
大島町	オオシママチ
加古川	カコガワ
血	ケツ
天覧山	テンランザン
歌志内市	ウタシナイシ
思想史	シソウシ
烏丸御池駅	カラスマオイケエキ
関屋駅	セキヤエキ
鳥取信用金庫	トットリシンヨウキンコ
東秩父村	ヒガシチチブムラ
反芻亜目	ハンスウアモク
隠岐どうぜん農業協同組合	オキドウゼンノウギョウキョウドウクミアイ
配線用差込接続器	ハイセンヨウサシコミセツゾクキ
暗黒星団帝国	アンコクセイダンテイコク
兵庫教育大学	ヒョウゴキョウイクダイガク
白色彗星帝国	ハクショクスイセイテイコク
食品消費個人責任法	ショクヒンショウヒコジンセキニンホウ
反射衛星砲	ハンシャエイセイホウ
厚別区	アツベツク
陸前高砂駅	リクゼンタカサゴエキ
多賀城駅	タガジョウエキ
最勝院	サイショウイン
金北山	キンポクサン
空気ばね	クウキバネ
後獣下綱	コウジュウカコウ
お花茶屋駅	オハナヂャヤエキ
堀切菖蒲園駅	ホリキリショウブエンエキ
国家安全保障問題担当大統領補佐官	コッカアンゼンホショウモンダイタントウダイトウリョウホサカン
こども学部	コドモガクブ
現金	ゲンキン
松島町	マツシママチ
為替	カワセ
送金	ソウキン
下馬駅	ゲバエキ
西塩釜駅	ニシシオガマエキ
日本相撲協会	ニホンスモウキョウカイ
東塩釜駅	ヒガシシオガマエキ
アジア太平洋学部	アジアタイヘイヨウガクブ
売買	バイバイ
石巻駅	イシノマキエキ
真理党	シンリトウ
貝田駅	カイダエキ
金融商品取引業	キンユウショウヒントリヒキギョウ
日本専売公社	ニッポンセンバイコウシャ
連動装置	レンドウソウチ
世界大戦	セカイタイセン
お市の方	オイチノカタ
手形交換所	テガタコウカンジョ
原獣亜綱	ゲンジュウアコウ
二元論	ニゲンロン
日本建築学会賞	ニホンケンチクガッカイショウ
衣浦豊田道路	キヌウラトヨタドウロ
古川組	フルカワグミ
式根島	シキネジマ
三省六部	サンショウリクブ
煎茶	センチャ
手樽駅	テタルエキ
陸前富山駅	リクゼントミヤマエキ
陸前大塚駅	リクゼンオオツカエキ
東名駅	トウナエキ
戦争犯罪	センソウハンザイ
陸前小野駅	リクゼンオノエキ
鹿妻駅	カヅマエキ
矢本駅	ヤモトエキ
東矢本駅	ヒガシヤモトエキ
陸前赤井駅	リクゼンアカイエキ
蛇田駅	ヘビタエキ
陸前山下駅	リクゼンヤマシタエキ
与野本町駅	ヨノホンマチエキ
功徳	クドク
地球防衛軍	チキュウボウエイグン
新島村	ニイジマムラ
群環	グンカン
鹿児島純心大学	カゴシマジュンシンダイガク
長崎純心大学	ナガサキジュンシンダイガク
靴	クツ
遠野市	トオノシ
信濃鉄道	シナノテツドウ
篠ノ井駅	シノノイエキ
五智如来	ゴチニョライ
坂本堤弁護士一家殺害事件	サカモトツツミベンゴシイッカサツガイジケン
後免駅	ゴメンエキ
長後駅	チョウゴエキ
玉鋼	タマハガネ
佐野市	サノシ
後免町駅	ゴメンマチエキ
桜ヶ丘駅	サクラガオカエキ
瀬谷駅	セヤエキ
相模大塚駅	サガミオオツカエキ
立田駅	タテダエキ
嫉妬	シット
神戸研究学園都市	コウベケンキュウガクエントシ
のいち駅	ノイチエキ
よしかわ駅	ヨシカワエキ
週刊誌	シュウカンシ
要塞	ヨウサイ
安芸区	アキク
宇佐別府道路	ウサベップドウロ
民間療法	ミンカンリョウホウ
研究科	ケンキュウカ
放射輝度	ホウシャキド
中浦和駅	ナカウラワエキ
北戸田駅	キタトダエキ
東川口駅	ヒガシカワグチエキ
金剛駅	コンゴウエキ
細胞質基質	サイボウシツキシツ
清里町	キヨサトチョウ
千住大橋駅	センジュオオハシエキ
翼軍	ツバサグン
政治学者の一覧	セイジガクシャノイチラン
千姫	センヒメ
布団	フトン
過剰数	カジョウスウ
羯	ケツ
公証人役場事務長逮捕監禁致死事件	コウショウニンヤクバジムチョウタイホカンキンチシジケン
日本の女優一覧	ニホンノジョユウイチラン
日本の男優一覧	ニホンノダンユウイチラン
四国山地	シコクサンチ
保津峡駅	ホヅキョウエキ
丹波口駅	タンバグチエキ
斜里町	シャリチョウ
金沢東部環状道路	カナザワトウブカンジョウドウロ
嫌気呼吸	ケンキコキュウ
羌	キョウ
国公立大学	コッコウリツダイガク
あかおか駅	アカオカエキ
香我美駅	カガミエキ
夜須駅	ヤスエキ
鷺沼車両基地	サギヌマシャリョウキチ
北海道新幹線	ホッカイドウシンカンセン
西分駅	ニシブンエキ
否認主義	ヒニンシュギ
上川内駅	カミセンダイエキ
阿久根駅	アクネエキ
桜前線	サクラゼンセン
主日	シュジツ
るりあ046	ルリアゼロヨンロク
母音	ボイン
氐	テイ
新御茶ノ水駅	シンオチャノミズエキ
阿寒湖特別	アカンコトクベツ
登別市	ノボリベツシ
古神道	コシントウ
円仁	エンニン
単項式	タンコウシキ
小清水町	コシミズチョウ
東藻琴村	ヒガシモコトムラ
女満別空港	メマンベツクウコウ
美幌町	ビホロチョウ
岡山商科大学	オカヤマショウカダイガク
基礎工学部	キソコウガクブ
社会福祉法人	シャカイフクシホウジン
刀剣	トウケン
微分音	ビブンオン
飛騨美濃道路	ヒダミノドウロ
別天津神	コトアマツカミ
根源	コンゲン
懐王	カイオウ
製造業	セイゾウギョウ
水晶島	スイショウジマ
直江津駅	ナオエツエキ
恵庭市	エニワシ
石狩市	イシカリシ
伝国璽	デンコクジ
玉璽	ギョクジ
和製漢字	ワセイカンジ
活水女子大学	カッスイジョシダイガク
13cm	ジュウサンセンチ
陸前白沢駅	リクゼンシラサワエキ
熊ケ根駅	クマガネエキ
新宿御苑前駅	シンジュクギョエンマエエキ
作並駅	サクナミエキ
八ツ森駅	ヤツモリエキ
奥新川駅	オクニッカワエキ
面白山高原駅	オモシロヤマコウゲンエキ
山寺駅	ヤマデラエキ
紀元前500年	キゲンゼンゴヒャクネン
文系と理系	ブンケイトリケイ
順序数	ジュンジョスウ
梁山泊	リョウザンパク
重版	ジュウハン
版元	ハンモト
明治の森高尾国定公園	メイジノモリタカオコクテイコウエン
大阪狭山市	オオサカサヤマシ
和食駅	ワジキエキ
赤野駅	アカノエキ
穴内駅	アナナイエキ
日本美術院	ニホンビジュツイン
伊尾木駅	イオキエキ
半母音	ハンボイン
門司港駅	モジコウエキ
低公害車	テイコウガイシャ
不審船事件	フシンセンジケン
不審船	フシンセン
肉球	ニクキュウ
唐浜駅	トウノハマエキ
新居浜太鼓祭り	ニイハマタイコマツリ
高知駅	コウチエキ
諏訪市	スワシ
映画作品一覧	エイガサクヒンイチラン
名東区	メイトウク
富田林市	トンダバヤシシ
日展	ニッテン
番組	バングミ
素数判定	ソスウハンテイ
成増駅	ナリマスエキ
近鉄八尾駅	キンテツヤオエキ
大和八木駅	ヤマトヤギエキ
別子銅山	ベッシドウザン
安満宮山古墳	アマミヤヤマコフン
精液	セイエキ
復水器	フクスイキ
落下	ラッカ
湯島駅	ユシマエキ
千駄木駅	センダギエキ
根津駅	ネヅエキ
南都七大寺	ナントシチダイジ
狂言	キョウゲン
心即理	シンソクリ
日本の信用組合一覧	ニホンノシンヨウクミアイイチラン
致良知	チリョウチ
富山県信用組合	トヤマケンシンヨウクミアイ
知行合一	チコウゴウイツ
灯台	トウダイ
楯山駅	タテヤマエキ
藤田駅	フジタエキ
桑折駅	コオリエキ
伊達駅	ダテエキ
東福島駅	ヒガシフクシマエキ
看護	カンゴ
逢隈駅	オオクマエキ
亘理駅	ワタリエキ
浜吉田駅	ハマヨシダエキ
坂元駅	サカモトエキ
現代の音楽	ゲンダイノオンガク
薊野駅	アゾウノエキ
びわ湖浜大津駅	ビワコハマオオツエキ
中書島駅	チュウショジマエキ
亀有	カメアリ
矢切	ヤキリ
登別川	ノボリベツカワ
大分一家6人殺傷事件	オオイタイッカロクニンサッショウジケン
中華民国総統選挙	チュウカミンコクソウトウセンキョ
塩嶺御野立記念祭	エンレイオノダチキネンサイ
氷川女体神社	ヒカワニョタイジンジャ
浅沼稲次郎暗殺事件	アサヌマイネジロウアンサツジケン
加平出入口	カヘイデイリグチ
電気化学	デンキカガク
調神社	ツキジンジャ
今治駅	イマバリエキ
波止浜駅	ハシハマエキ
波方駅	ナミカタエキ
大西駅	オオニシエキ
伊予亀岡駅	イヨカメオカエキ
菊間駅	キクマエキ
浅海駅	アサナミエキ
大浦駅	オオウラエキ
伊予北条駅	イヨホウジョウエキ
粟井駅	アワイエキ
諏訪盆地	スワボンチ
言葉狩り	コトバガリ
名古屋金鯱軍	ナゴヤキンコグン
大和軍	ヤマトグン
猿岩駅	サルイワエキ
乙女坂駅	オトメザカエキ
美濃大久保駅	ミノオオクボエキ
昼飯駅	ヒルイエキ
校内暴力	コウナイボウリョク
成田山新勝寺	ナリタサンシンショウジ
徳之島	トクノシマ
高尾山薬王院	タカオサンヤクオウイン
第一興商	ダイイチコウショウ
全国労働者共済生活協同組合連合会	ゼンコクロウドウシャキョウサイセイカツキョウドウクミアイレンゴウカイ
養命酒	ヨウメイシュ
名古屋高速都心環状線	ナゴヤコウソクトシンカンジョウセン
宮之阪駅	ミヤノサカエキ
村野駅	ムラノエキ
小菅出入口	コスゲデイリグチ
交野市駅	カタノシエキ
郡津駅	コウヅエキ
河内森駅	カワチモリエキ
天神南駅	テンジンミナミエキ
軽自動車	ケイジドウシャ
砲兵	ホウヘイ
豊北町	ホウホクチョウ
かつらぎ町	カツラギチョウ
陣馬山	ジンバサン
沢登り	サワノボリ
陳橋の変	チンキョウノヘン
四つ木出入口	ヨツギデイリグチ
首都高速中央環状線	シュトコウソクチュウオウカンジョウセン
朝鮮八道	チョウセンハチドウ
川之江駅	カワノエエキ
伊予三島駅	イヨミシマエキ
伊予寒川駅	イヨサンガワエキ
赤星駅	アカボシエキ
伊予土居駅	イヨドイエキ
関川駅	セキガワエキ
多喜浜駅	タキハマエキ
新居浜駅	ニイハマエキ
伊予西条駅	イヨサイジョウエキ
石鎚山駅	イシヅチヤマエキ
伊予氷見駅	イヨヒミエキ
伊予小松駅	イヨコマツエキ
玉之江駅	タマノエエキ
壬生川駅	ニュウガワエキ
伊予三芳駅	イヨミヨシエキ
伊予桜井駅	イヨサクライエキ
伊予富田駅	イヨトミタエキ
太田市	オオタシ
ポンアヨロ川	ポンアヨロカワ
首都高速湾岸線	シュトコウソクワンガンセン
尾島町	オジママチ
舞浜入口	マイハマイリグチ
谷保天満宮	ヤボテンマングウ
石清水八幡宮駅	イワシミズハチマングウエキ
隈之城駅	クマノジョウエキ
首都高速都心環状線	シュトコウソクトシンカンジョウセン
木場茶屋駅	コバンチャヤエキ
大阪狭山市駅	オオサカサヤマシエキ
砲台	ホウダイ
専門機関	センモンキカン
清新町出入口	セイシンチョウデイリグチ
千住新橋出入口	センジュシンバシデイリグチ
須ヶ口駅	スカグチエキ
握取行為	アクシュコウイ
甚目寺駅	ジモクジエキ
扇大橋出入口	オウギオオハシデイリグチ
七宝駅	シッポウエキ
勝幡駅	ショバタエキ
藤浪駅	フジナミエキ
木田駅	キダエキ
青塚駅	アオツカエキ
王子北出入口	オウジキタデイリグチ
王子南出入口	オウジミナミデイリグチ
津島駅	ツシマエキ
町方駅	マチカタエキ
滝野川入口	タキノガワイリグチ
六輪駅	ロクワエキ
新板橋出口	シンイタバシデグチ
人種差別	ジンシュサベツ
首都高速八重洲線	シュトコウソクヤエスセン
渕高駅	フチダカエキ
宝町出入口	タカラチョウデイリグチ
丸渕駅	マルブチエキ
上丸渕駅	カミマルブチエキ
大同倶楽部	ダイドウクラブ
新富町出口	シントミチョウデグチ
銀座出入口	ギンザデイリグチ
汐留出入口	シオドメデイリグチ
八坂神社	ヤサカジンジャ
枇杷島分岐点	ビワジマブンキテン
名鉄一宮駅	メイテツイチノミヤエキ
雲と波と少年と	クモトナミトショウネント
国府宮駅	コウノミヤエキ
佐屋駅	サヤエキ
五ノ三駅	ゴノサンエキ
弥富口駅	ヤトミグチエキ
弥富駅	ヤトミエキ
尾張一宮駅	オワリイチノミヤエキ
軟骨魚綱	ナンコツギョコウ
岐阜駅	ギフエキ
日高市	ヒダカシ
高麗川駅	コマガワエキ
武蔵高萩駅	ムサシタカハギエキ
佐倉駅	サクラエキ
桐生駅	キリュウエキ
前橋駅	マエバシエキ
新前橋駅	シンマエバシエキ
籠原駅	カゴハラエキ
倉賀野駅	クラガノエキ
明覚駅	ミョウカクエキ
西小泉駅	ニシコイズミエキ
国領川	コクリョウガワ
館林市	タテバヤシシ
表現技法	ヒョウゲンギホウ
丹羽長秀	ニワナガヒデ
魔法少女	マホウショウジョ
鳳来町	ホウライチョウ
水戸駅	ミトエキ
日本金属学会	ニッポンキンゾクガッカイ
地上波	チジョウハ
鹿児島駅	カゴシマエキ
最高人民会議	サイコウジンミンカイギ
球体	キュウタイ
いわき駅	イワキエキ
寝袋	ネブクロ
徳沢駅	トクサワエキ
渋川駅	シブカワエキ
芝公園出入口	シバコウエンデイリグチ
飯倉出入口	イイクラデイリグチ
霞が関出入口	カスミガセキデイリグチ
北の丸出口	キタノマルデグチ
神田橋出入口	カンダバシデイリグチ
笹神村	ササカミムラ
黒潮	クロシオ
呉服橋出入口	ゴフクバシデイリグチ
江戸橋出入口	エドバシデイリグチ
京ヶ瀬村	キョウガセムラ
語尾	ゴビ
入間市	イルマシ
諜報活動	チョウホウカツドウ
寒の土用の丑の日	カンノドヨウノウシノヒ
極楽とんぼの吠え魂	ゴクラクトンボノホエダマ
鶴舞駅	ツルマイエキ
監察医	カンサツイ
川名駅	カワナエキ
いりなか駅	イリナカエキ
八事駅	ヤゴトエキ
塩釜口駅	シオガマグチエキ
浄心駅	ジョウシンエキ
庄内緑地公園駅	ショウナイリョクチコウエンエキ
解剖	カイボウ
東別院駅	ヒガシベツインエキ
原駅	ハラエキ
演芸	エンゲイ
南船橋駅	ミナミフナバシエキ
中小企業	チュウショウキギョウ
無尽	ムジン
雷門	カミナリモン
天然理心流	テンネンリシンリュウ
種市町	タネイチマチ
近江兄弟社	オウミキョウダイシャ
作手村	ツクデムラ
清洲町	キヨスチョウ
伝染病	デンセンビョウ
隷書体	レイショタイ
新潟大学前駅	ニイガタダイガクマエエキ
錦糸町出入口	キンシチョウデイリグチ
小松川出入口	コマツガワデイリグチ
一之江出入口	イチノエデイリグチ
三溪園	サンケイエン
恩賜上野動物園	トウキョウトオンシウエノドウブツエン
朝日新聞社	アサヒシンブンシャ
観月橋駅	カンゲツキョウエキ
仙台市八木山動物公園	センダイシヤギヤマドウブツコウエン
三ケ日町	ミッカビチョウ
森上駅	モリカミエキ
亀山市	カメヤマシ
玉野駅	タマノエキ
二子駅	フタゴエキ
高調波	コウチョウハ
苅安賀駅	カリヤスカエキ
西一宮駅	ニシイチノミヤエキ
開明駅	カイメイエキ
奥町駅	オクチョウエキ
玉ノ井駅	タマノイエキ
羽島市役所前駅	ハシマシヤクショマエエキ
江吉良駅	エギラエキ
鳴海駅	ナルミエキ
新三河島駅	シンミカワシマエキ
国府台駅	コウノダイエキ
市川真間駅	イチカワママエキ
菅野駅	スガノエキ
鬼越駅	オニゴエエキ
京成中山駅	ケイセイナカヤマエキ
ものまね四天王	モノマネシテンノウ
登山靴	トザングツ
海神駅	カイジンエキ
大神宮下駅	ダイジングウシタエキ
対句	ツイク
押韻	オウイン
列車番号	レッシャバンゴウ
変死体	ヘンシタイ
名古屋証券取引所	ナゴヤショウケントリヒキジョ
自殺した有名人の一覧	ジサツシタユウメイジンノイチラン
阪神鳴尾浜球場	ハンシンナルオハマキュウジョウ
約物	ヤクモノ
灘中学校	ナダチュウガッコウ
証券	ショウケン
扇子	センス
山梨日日新聞	ヤマナシニチニチシンブン
指名打者	シメイダシャ
松下村塾	ショウカソンジュク
多摩川緑地広場硬式野球場	タマガワリョクチヒロバコウシキヤキュウジョウ
電脳化	デンノウカ
春日市	カスガシ
戸田球場	トダキュウジョウ
青井駅	アオイエキ
六町駅	ロクチョウエキ
八潮駅	ヤシオエキ
立体配座	リッタイハイザ
先物取引	サキモノトリヒキ
永延	エイエン
戸籍	コセキ
松井山手駅	マツイヤマテエキ
高志会	コウシカイ
新生党	シンセイトウ
沖縄県立看護大学	オキナワケンリツカンゴダイガク
清和政策研究会	セイワセイサクケンキュウカイ
猛獣	モウジュウ
二条城前駅	ニジョウジョウマエエキ
司法解剖	シホウカイボウ
行政解剖	ギョウセイカイボウ
久喜駅	クキエキ
情報革命	ジョウホウカクメイ
垂直感染	スイチョクカンセン
都賀駅	ツガエキ
新城駅	シンシロエキ
尾瀬沼	オゼヌマ
干潟駅	ヒガタエキ
簡易裁判所	カンイサイバンショ
沖縄県立芸術大学	オキナワケンリツゲイジュツダイガク
魯班尺	ロハンシャク
一次関数	イチジカンスウ
紛争	フンソウ
禁則処理	キンソクショリ
安倍川	アベカワ
安倍川駅	アベカワエキ
草薙駅	クサナギエキ
静岡浅間神社	シズオカセンゲンジンジャ
常葉大学	トコハダイガク
後閑駅	ゴカンエキ
八坂女紅場学園	ヤサカニョコウバガクエン
新人物往来社	シンジンブツオウライシャ
米百俵	コメヒャッピョウ
東照宮	トウショウグウ
偏微分	ヘンビブン
私の秘密	ワタシノヒミツ
北九州市民球場	キタキュウシュウシミンキュウジョウ
高松東道路	タカマツヒガシドウロ
日本新党	ニホンシントウ
鏡新明智流	キョウシンメイチリュウ
新横浜元石川線	シンヨコハマモトイシカワセン
二本木駅	ニホンギエキ
一刀流	イットウリュウ
漢音	カンオン
呉音	ゴオン
大学生協	ダイガクセイキョウ
天真正伝香取神道流	テンシンショウデンカトリシントウリュウ
関山駅	セキヤマエキ
仲御徒町駅	ナカオカチマチエキ
繁殖牝馬	ハンショクヒンバ
競走馬	キョウソウバ
坪	ツボ
二条駅	ニジョウエキ
群馬県の県道一覧	グンマケンノケンドウイチラン
八重歯	ヤエバ
上顎第一大臼歯	ジョウガクダイイチダイキュウシ
姓名判断	セイメイハンダン
中川家	ナカガワケ
琴似発寒川	コトニハッサムガワ
丸太町駅	マルタマチエキ
京都銀行	キョウトギンコウ
国民健康保険税	コクミンケンコウホケンゼイ
池田銀行	イケダギンコウ
泉州銀行	センシュウギンコウ
運転免許	ウンテンメンキョ
中継局	チュウケイキョク
路側帯	ロソクタイ
車道外側線	シャドウガイソクセン
歩道	ホドウ
卒業検定	ソツギョウケンテイ
葉緑体	ヨウリョクタイ
指定自動車教習所	シテイジドウシャキョウシュウジョ
木下駅	キオロシエキ
仮運転免許	カリウンテンメンキョ
坂道発進	サカミチハッシン
富里市	トミサトシ
運転免許試験場	ウンテンメンキョシケンジョウ
運転免許証	ウンテンメンキョショウ
車両通行帯	シャリョウツウコウタイ
車線	シャセン
進路変更	シンロヘンコウ
放送記念日	ホウソウキネンビ
上方舞	カミガタマイ
帯広畜産大学	オビヒロチクサンダイガク
東京都庁	トウキョウトチョウ
光の波動説	ヒカリノハドウセツ
台本	ダイホン
信濃毎日新聞	シナノマイニチシンブン
塚目駅	ツカノメエキ
西古川駅	ニシフルカワエキ
東大崎駅	ヒガシオオサキエキ
西大崎駅	ニシオオサキエキ
岩出山駅	イワデヤマエキ
有備館駅	ユウビカンエキ
上野目駅	カミノメエキ
池月駅	イケヅキエキ
川渡温泉駅	カワタビオンセンエキ
鳴子御殿湯駅	ナルコゴテンユエキ
中山平温泉駅	ナカヤマダイラオンセンエキ
堺田駅	サカイダエキ
赤倉温泉駅	アカクラオンセンエキ
立小路駅	タチコウジエキ
最上駅	モガミエキ
大堀駅	オオホリエキ
鵜杉駅	ウスギエキ
瀬見温泉駅	セミオンセンエキ
東長沢駅	ヒガシナガサワエキ
長沢駅	ナガサワエキ
南新庄駅	ミナミシンジョウエキ
上涌谷駅	カミワクヤエキ
涌谷駅	ワクヤエキ
前谷地駅	マエヤチエキ
佳景山駅	カケヤマエキ
鹿又駅	カノマタエキ
曽波神駅	ソバノカミエキ
平間寺	ヘイケンジ
陸前稲井駅	リクゼンイナイエキ
渡波駅	ワタノハエキ
万石浦駅	マンゴクウラエキ
沢田駅	サワダエキ
浦宿駅	ウラシュクエキ
女川駅	オナガワエキ
花博	ハナハク
琴似駅	コトニエキ
大山阿夫利神社	オオヤマアフリジンジャ
二酸化炭素飢餓	ニサンカタンソキガ
泉佐野市	イズミサノシ
栃木駅	トチギエキ
明治法律学校	メイジホウリツガッコウ
宮城教育大学	ミヤギキョウイクダイガク
札幌医科大学	サッポロイカダイガク
四条駅	シジョウエキ
新木駅	アラキエキ
結び目	ムスビメ
布佐駅	フサエキ
久住駅	クズミエキ
引き上げ線	ヒキアゲセン
本線	ホンセン
2進接頭辞	ニシンセットウジ
公津の杜駅	コウヅノモリエキ
宗吾参道駅	ソウゴサンドウエキ
内幸町	ウチサイワイチョウ
四谷	ヨツヤ
常微分方程式	ジョウビブンホウテイシキ
津別町	ツベツチョウ
作草部駅	サクサベエキ
学校法人千葉経済学園	ガッコウホウジンチバケイザイガクエン
非営利団体	ヒエイリダンタイ
外様	トザマ
紋別市	モンベツシ
球面	キュウメン
公方	クボウ
大道芸	ダイドウゲイ
舞田駅	マイタエキ
支援費制度	シエンヒセイド
和歌山県立医科大学	ワカヤマケンリツイカダイガク
奈良県立医科大学	ナラケンリツイカダイガク
浜松医科大学	ハママツイカダイガク
伏見区	フシミク
右京区	ウキョウク
山科区	ヤマシナク
下京区	シモギョウク
銚子駅	チョウシエキ
双曲線関数	ソウキョクセンカンスウ
峰山町	ミネヤマチョウ
千葉公園駅	チバコウエンエキ
鶴見市場駅	ツルミイチバエキ
駅弁大学	エキベンダイガク
上野高等学校	ウエノコウトウガッコウ
埴輪	ハニワ
三田会	ミタカイ
伯耆町有線テレビジョン放送	ホウキチョウユウセンテレビジョンホウソウ
法人特別税	ホウジントクベツゼイ
航空機燃料税	コウクウキネンリョウゼイ
入湯税	ニュウトウゼイ
水利地益税	スイリチエキゼイ
幕張	マクハリ
門司区	モジク
八代市	ヤツシロシ
玉名市	タマナシ
筑後市	チクゴシ
西小倉駅	ニシコクラエキ
南福岡駅	ミナミフクオカエキ
白衣	ハクイ
若松河田駅	ワカマツカワダエキ
熊本駅	クマモトエキ
久留米駅	クルメエキ
佐賀駅	サガエキ
武雄温泉駅	タケオオンセンエキ
大佐倉駅	オオサクラエキ
徳島新聞	トクシマシンブン
京成酒々井駅	ケイセイシスイエキ
馬見ヶ崎川	マミガサキガワ
有効需要	ユウコウジュヨウ
観音開き	カンノンビラキ
慶應義塾高等学校	ケイオウギジュクコウトウガッコウ
血液検査	ケツエキケンサ
上山市	カミノヤマシ
御堂筋	ミドウスジ
天童市	テンドウシ
示準化石	シジュンカセキ
歴史文学賞	レキシブンガクショウ
深大寺	ジンダイジ
太閤	タイコウ
射水市	イミズシ
松伏町	マツブシマチ
自然選択説	シゼンセンタクセツ
検死	ケンシ
検視	ケンシ
寺社奉行	ジシャブギョウ
三井家	ミツイケ
酒田市	サカタシ
阪南市	ハンナンシ
潜望鏡	センボウキョウ
雄琴	オゴト
電源開発促進税	デンゲンカイハツソクシンゼイ
東陽町駅	トウヨウチョウエキ
地方揮発油税	チホウキハツユゼイ
軽油引取税	ケイユヒキトリゼイ
自動車取得税	ジドウシャシュトクゼイ
法定外普通税	ホウテイガイフツウゼイ
酒税	シュゼイ
利府町	リフチョウ
八日市場駅	ヨウカイチバエキ
旭市	アサヒシ
可児川駅	カニガワエキ
西可児駅	ニシカニエキ
志都美駅	シズミエキ
亭号	テイゴウ
門前仲町駅	モンゼンナカチョウエキ
辰巳駅	タツミエキ
上方落語協会	カミガタラクゴキョウカイ
上野広小路駅	ウエノヒロコウジエキ
上野御徒町駅	ウエノオカチマチエキ
本郷三丁目駅	ホンゴウサンチョウメエキ
検疫	ケンエキ
度会県	ワタライケン
居合道	イアイドウ
共通鍵暗号	キョウツウカギアンゴウ
霊術	レイジュツ
庄内平野	ショウナイヘイヤ
新地駅	シンチエキ
背番号	セバンゴウ
泉南市	センナンシ
鴻巣市	コウノスシ
坂戸市	サカドシ
道後温泉	ドウゴオンセン
天台駅	テンダイエキ
甲府	コウフ
竹下駅	タケシタエキ
千鳥駅	チドリエキ
東郷駅	トウゴウエキ
戸畑駅	トバタエキ
笹原駅	ササバルエキ
吉塚駅	ヨシヅカエキ
公国	コウコク
駒ケ嶺駅	コマガミネエキ
相馬駅	ソウマエキ
日立木駅	ニッタキエキ
鹿島駅	カシマエキ
原ノ町駅	ハラノマチエキ
箱崎駅	ハコザキエキ
破門	ハモン
航空に関する年表	コウクウニカンスルネンピョウ
大和高田駅	ヤマトタカダエキ
淡路町駅	アワジチョウエキ
栗橋駅	クリハシエキ
中井駅	ナカイエキ
三枚橋駅	サンマイバシエキ
治良門橋駅	ジロエンバシエキ
中菰野駅	ナカコモノエキ
大羽根園駅	オオバネエンエキ
湯の山温泉駅	ユノヤマオンセンエキ
高角駅	タカツノエキ
篠塚駅	シノヅカエキ
東小泉駅	ヒガシコイズミエキ
伊勢川島駅	イセカワシマエキ
伊勢松本駅	イセマツモトエキ
小泉町駅	コイズミマチエキ
中川原駅	ナカガワラエキ
竜舞駅	リュウマイエキ
南予地方	ナンヨチホウ
大矢知駅	オオヤチエキ
平津駅	ヘイヅエキ
暁学園前駅	アカツキガクエンマエエキ
山城駅	ヤマジョウエキ
保々駅	ホボエキ
北勢中央公園口駅	ホクセイチュウオウコウエングチエキ
梅戸井駅	ウメドイエキ
千早駅	ニシテツチハヤエキ
三里駅	ミサトエキ
丹生川駅	ニュウガワエキ
伊勢治田駅	イセハッタエキ
東藤原駅	ヒガシフジワラエキ
西野尻駅	ニシノジリエキ
西藤原駅	ニシフジワラエキ
香椎駅	カシイエキ
九産大前駅	キュウサンダイマエエキ
福間駅	フクマエキ
東福間駅	ヒガシフクマエキ
ひろせ野鳥の森駅	ヒロセヤチョウノモリエキ
赤間駅	アカマエキ
教育大前駅	キョウイクダイマエエキ
海老津駅	エビツエキ
水巻駅	ミズマキエキ
折尾駅	オリオエキ
福島高等商業学校	フクシマコウトウショウギョウガッコウ
高田市駅	タカダシエキ
改竄	カイザン
陣原駅	ジンノハルエキ
黒崎駅	クロサキエキ
岡谷駅	オカヤエキ
鯖江駅	サバエエキ
誘導爆弾	ユウドウバクダン
武国凝別皇子	タケクニコリワケノミコ
枝光駅	エダミツエキ
鯖江市	サバエシ
新居大島	ニイオオシマ
城野駅	ジョウノエキ
早慶	ソウケイ
独任制	ドクニンセイ
犀潟駅	サイガタエキ
うらがわら駅	ウラガワラエキ
春日山駅	カスガヤマエキ
南高田駅	ミナミタカダエキ
上越妙高駅	ジョウエツミョウコウエキ
福井新聞	フクイシンブン
春日山神社	カスガヤマジンジャ
土底浜駅	ドソコハマエキ
入学	ニュウガク
潟町駅	カタマチエキ
虫川大杉駅	ムシガワオオスギエキ
入学式	ニュウガクシキ
北海道拓殖銀行	ホッカイドウタクショクギンコウ
道後	ドウゴ
魚沼丘陵駅	ウオヌマキュウリョウエキ
ほくほく大島駅	ホクホクオオシマエキ
しんざ駅	シンザエキ
大池いこいの森駅	オオイケイコイノモリエキ
白魚橋乗継所	シラウオバシノリツギジョ
第三次奴隷戦争	ダイサンジドレイセンソウ
殺人罪	サツジンザイ
川岸駅	カワギシエキ
極東	キョクトウ
金融持株会社	キンユウモチカブガイシャ
日本橋兜町	ニホンバシカブトチョウ
落ち	オチ
白人	ハクジン
諏訪湖	スワコ
東急百貨店本店	トウキュウヒャッカテンホンテン
米子信用金庫	ヨナゴシンヨウキンコ
西日本銀行	ニシニッポンギンコウ
普通選挙法	フツウセンキョホウ
柔術	ジュウジュツ
田無市	タナシシ
大学教員	ダイガクキョウイン
不動産会社	フドウサンガイシャ
南福島駅	ミナミフクシマエキ
金谷川駅	カナヤガワエキ
八幡市	ヤワタシ
松川駅	マツカワエキ
安達駅	アダチエキ
二本松駅	ニホンマツエキ
原宿	ハラジュク
三桂	サンケイ
酒々井駅	シスイエキ
長野工業高等専門学校	ナガノコウギョウコウトウセンモンガッコウ
住友家	スミトモケ
三才駅	サンサイエキ
彦根高等商業学校	ヒコネコウトウショウギョウガッコウ
滋賀医科大学	シガイカダイガク
財閥解体	ザイバツカイタイ
和歌山高等商業学校	ワカヤマコウトウショウギョウガッコウ
長崎高等学校	ナガサキコウトウガッコウ
長崎高等商業学校	ナガサキコウトウショウギョウガッコウ
童貞	ドウテイ
処女	ショジョ
処女膜	ショジョマク
正五位	ショウゴイ
位階	イカイ
静岡県草薙総合運動場硬式野球場	シズオカケンクサナギソウゴウウンドウジョウコウシキヤキュウジョウ
江南市	コウナンシ
宮城工業高等専門学校	ミヤギコウギョウコウトウセンモンガッコウ
日本の高等専門学校一覧	ニホンノコウトウセンモンガッコウイチラン
あさぎり町	アサギリチョウ
和道流	ワドウリュウ
剛柔流	ゴウジュウリュウ
新上五島町	シンカミゴトウチョウ
秘密結社	ヒミツケッシャ
東寺	トウジ
芦北町	アシキタマチ
無線	ムセン
上下浜駅	ジョウゲハマエキ
諫早市	イサハヤシ
谷浜駅	タニハマエキ
有間川駅	アリマガワエキ
杜の都	モリノミヤコ
第一種運転免許	ダイイッシュウンテンメンキョ
第二種運転免許	ダイニシュウンテンメンキョ
大東亜会議	ダイトウアカイギ
五百川駅	ゴヒャクガワエキ
日和田駅	ヒワダエキ
十字架の道行き	ジュウジカノミチユキ
加津佐町	カヅサマチ
堺市駅	サカイシエキ
五日町駅	イツカマチエキ
左大臣	サダイジン
望月寒川	モツキサムカワ
三平汁	サンペイジル
南魚沼市	ミナミウオヌマシ
紀陽銀行	キヨウギンコウ
六本木	ロッポンギ
金沢文庫	カネサワブンコ
紀元前400年	キゲンゼンヨンヒャクネン
真倉駅	マグラエキ
紀三井寺駅	キミイデラエキ
博多港	ハカタコウ
谷川駅	タニカワエキ
高鍋町	タカナベチョウ
紀和駅	キワエキ
気功	キコウ
脩子内親王	シュウシナイシンノウ
宥和政策	ユウワセイサク
統合教育	トウゴウキョウイク
神道文化学部	シントウブンカガクブ
専門職学位	センモンショクガクイ
機器分析化学	キキブンセキカガク
上天草市	カミアマクサシ
大矢野町	オオヤノマチ
姫戸町	ヒメドマチ
龍ヶ岳町	リュウガタケマチ
演算装置	エンザンソウチ
中間市	ナカマシ
輪中	ワジュウ
度量衡	ドリョウコウ
千載不決の議	センザイフケツノギ
新小平駅	シンコダイラエキ
武蔵高等学校中学校	ムサシコウトウガッコウチュウガッコウ
武蔵中学校	ムサシチュウガッコウ
武蔵高等学校	ムサシコウトウガッコウ
名立駅	ナダチエキ
双三郡	フタミグン
君田村	キミタソン
布野村	フノソン
作木村	サクギソン
吉舎町	キサチョウ
三良坂町	ミラサカチョウ
河口湖	カワグチコ
上下町	ジョウゲチョウ
甲奴町	コウヌチョウ
東御市	トウミシ
東部町	トウブマチ
新横浜	シンヨコハマ
阿波丸事件	アワマルジケン
藤岡市	フジオカシ
伊豆市	イズシ
御前崎市	オマエザキシ
京丹後市	キョウタンゴシ
養父市	ヤブシ
館山市	タテヤマシ
八千代市	ヤチヨシ
失調	シッチョウ
失明	シツメイ
天魔	テンマ
藤井寺球場	フジイデラキュウジョウ
冤罪	エンザイ
久美浜町	クミハマチョウ
山形新聞	ヤマガタシンブン
岬町	ミサキチョウ
旺文社	オウブンシャ
日本の画家一覧	ニホンノガカイチラン
東京理工系4大学	トウキョウリコウケイヨンダイガク
修善寺町	シュゼンジチョウ
土肥町	トイチョウ
天城湯ケ島町	アマギユガシマチョウ
中伊豆町	ナカイズチョウ
帝都高速度交通営団	テイトコウソクドコウツウエイダン
浜岡町	ハマオカチョウ
御前崎町	オマエザキチョウ
網野町	アミノチョウ
丹後町	タンゴチョウ
社交数	シャコウスウ
天保の改革	テンポウノカイカク
木場駅	キバエキ
南砂町駅	ミナミスナマチエキ
大月駅	オオツキエキ
南行徳駅	ミナミギョウトクエキ
行徳駅	ギョウトクエキ
物井駅	モノイエキ
原木中山駅	バラキナカヤマエキ
水上駅	ミナカミエキ
昼夜開講制	チュウヤカイコウセイ
新しい複雑性	アタラシイフクザツセイ
六書	リクショ
鉛版	エンバン
両替	リョウガエ
根上町	ネアガリマチ
大板井駅	オオイタイエキ
酢豚	スブタ
安積永盛駅	アサカナガモリエキ
麻生田駅	オウダエキ
上笠田駅	カミカサダエキ
楚原駅	ソハラエキ
滑川町	ナメガワマチ
六把野駅	ロッパノエキ
七和駅	ナナワエキ
在良駅	アリヨシエキ
蓮花寺駅	レンゲジエキ
西別所駅	ニシベッショエキ
馬道駅	ウマミチエキ
西桑名駅	ニシクワナエキ
安田財閥	ヤスダザイバツ
永田町	ナガタチョウ
庄内空港	ショウナイクウコウ
芝山町	シバヤママチ
漢語	カンゴ
最多盗塁	サイタトウルイ
酒田駅	サカタエキ
懐帝	カイテイ
戸塚安行駅	トヅカアンギョウエキ
大阪教育大前駅	オオサカキョウイクダイマエエキ
小倉北区	コクラキタク
歯の物理的損傷	ハノブツリテキソンショウ
乃木坂駅	ノギザカエキ
二重橋前駅	ニジュウバシマエエキ
喜多方市	キタカタシ
会津若松市	アイヅワカマツシ
西会津町	ニシアイヅマチ
第二水雷戦隊	ダイニスイライセンタイ
越後湯沢温泉	エチゴユザワオンセン
中野富士見町駅	ナカノフジミチョウエキ
川之江市	カワノエシ
脳虚血	ノウキョケツ
明浜町	アケハマチョウ
宇和町	ウワチョウ
野村町	ノムラチョウ
城川町	シロカワチョウ
三瓶町	ミカメチョウ
特別区競馬組合	トクベツクケイバクミアイ
区長	クチョウ
沢村栄治賞	サワムラエイジショウ
南北線	ナンボクセン
全国七大学総合体育大会	ゼンコクナナダイガクソウゴウタイイクタイカイ
中野会	ナカノカイ
剛体架線	ゴウタイカセン
小城駅	オギエキ
軍手	グンテ
交直流電車	コウチョクリュウデンシャ
中国の剰余定理	チュウゴクノジョウヨテイリ
千原兄弟	チハラキョウダイ
災害心理学	サイガイシンリガク
劉弘	リュウコウ
米山駅	ヨネヤマエキ
隠王	インオウ
笠島駅	カサシマエキ
座席	ザセキ
青海川駅	オウミガワエキ
鯨波駅	クジラナミエキ
椅子	イス
柏崎駅	カシワザキエキ
放下	ホウカ
頃王	ケイオウ
出身成分	シュッシンセイブン
船中八策	センチュウハッサク
北新井駅	キタアライエキ
障害者差別	ショウガイシャサベツ
公開処刑	コウカイショケイ
妙高高原駅	ミョウコウコウゲンエキ
旅団	リョダン
吉田五十八賞	ヨシダイソヤショウ
大日本帝国陸軍の軍の一覧	ダイニッポンテイコクリクグンノグンノイチラン
小田急電鉄直営事業	オダキュウデンテツチョクエイジギョウ
村野藤吾賞	ムラノトウゴショウ
飯山満駅	ハサマエキ
守谷市	モリヤシ
塩沢町	シオザワマチ
六日町	ムイカマチ
紀行	キコウ
中尉	チュウイ
中ノ鳥島	ナカノトリシマ
森林	シンリン
東大前駅	トウダイマエエキ
本駒込駅	ホンコマゴメエキ
阿佐ケ谷駅	アサガヤエキ
洞窟	ドウクツ
光緒新政	コウショシンセイ
帽子	ボウシ
音羽町駅	オトワチョウエキ
魔神転生	マジンテンセイ
蜜	ミツ
中心極限定理	チュウシンキョクゲンテイリ
受精卵	ジュセイラン
西ケ原駅	ニシガハラエキ
人格	ジンカク
水虫の唄	ミズムシノウタ
桜美林大学	オウビリンダイガク
座席指定券	ザセキシテイケン
弘前高等学校	ヒロサキコウトウガッコウ
寝屋川	ネヤガワ
大間々駅	オオママエキ
前橋大島駅	マエバシオオシマエキ
駒形駅	コマガタエキ
矢部町	ヤベマチ
国定駅	クニサダエキ
岩宿駅	イワジュクエキ
山前駅	ヤママエエキ
業務請負	ギョウムウケオイ
足利駅	アシカガエキ
岩舟駅	イワフネエキ
大平下駅	オオヒラシタエキ
思川駅	オモイガワエキ
八街駅	ヤチマタエキ
横芝駅	ヨコシバエキ
飯倉駅	イイグラエキ
飯岡駅	イイオカエキ
猿田駅	サルダエキ
倉橋駅	クラハシエキ
松岸駅	マツギシエキ
神岡鉱山	カミオカコウザン
女子大駅	ジョシダイエキ
五穀	ゴコク
実業家	ジツギョウカ
思想	シソウ
州都	シュウト
寄居町	ヨリイマチ
土俵	ドヒョウ
新制大学	シンセイダイガク
邑楽町	オウラマチ
千代田町	チヨダマチ
住民	ジュウミン
板倉町	イタクラマチ
若葉区	ワカバク
稚内空港	ワッカナイクウコウ
大人計画	オトナケイカク
方面軍	ホウメングン
多喜浜塩田	タキハマエンデン
ちはら台駅	チハラダイエキ
沖縄放送協会	オキナワホウソウキョウカイ
外苑出入口	ガイエンデイリグチ
かたつむり大作戦	カタツムリダイサクセン
負債	フサイ
煉瓦	レンガ
大島空港	オオシマクウコウ
狛犬	コマイヌ
蓮田市	ハスダシ
鶴ヶ島市	ツルガシマシ
西入善駅	ニシニュウゼンエキ
能生駅	ノウエキ
浦本駅	ウラモトエキ
梶屋敷駅	カジヤシキエキ
糸魚川駅	イトイガワエキ
牛込柳町駅	ウシゴメヤナギチョウエキ
牛込神楽坂駅	ウシゴメカグラザカエキ
親不知駅	オヤシラズエキ
勝どき駅	カチドキエキ
市振駅	イチブリエキ
肥前古賀駅	ヒゼンコガエキ
四谷三丁目駅	ヨツヤサンチョウメエキ
西新宿駅	ニシシンジュクエキ
新中野駅	シンナカノエキ
字母	ジボ
東高円寺駅	ヒガシコウエンジエキ
信頼性設計	シンライセイセッケイ
南阿佐ケ谷駅	ミナミアサガヤエキ
印西市	インザイシ
乳海攪拌	ニュウカイカクハン
愛媛新聞	エヒメシンブン
電子署名	デンシショメイ
羽田出入口	ハネダデイリグチ
特別席	トクベツセキ
音読み	オンヨミ
塩尻峠	シオジリトウゲ
平和島出入口	ヘイワジマデイリグチ
鈴ヶ森出入口	スズガモリデイリグチ
勝島出入口	カツシマデイリグチ
芝浦出入口	シバウラデイリグチ
呉港	クレコウ
有	ウ
巨乳	キョニュウ
仁和寺	ニンナジ
論文	ロンブン
司法研修所	シホウケンシュウジョ
新田町	ニッタマチ
判事	ハンジ
校歌	コウカ
直鎖	チョクサ
証券会社	ショウケンガイシャ
堤通出入口	ツツミドオリデイリグチ
軍集団	グンシュウダン
中隊	チュウタイ
小隊	ショウタイ
向島出入口	ムコウジマデイリグチ
駒形出入口	コマガタデイリグチ
須賀川駅	スカガワエキ
鏡石駅	カガミイシエキ
矢吹駅	ヤブキエキ
箱根温泉	ハコネオンセン
泉崎駅	イズミザキエキ
久田野駅	クタノエキ
白坂駅	シラサカエキ
豊原駅	トヨハラエキ
黒田原駅	クロダハラエキ
高久駅	タカクエキ
たばこの銘柄一覧	タバコノメイガライチラン
仁堀連絡船	ニホリレンラクセン
春田駅	ハルタエキ
蟹江駅	カニエエキ
永和駅	エイワエキ
長島駅	ナガシマエキ
羽生市	ハニュウシ
朝日駅	アサヒエキ
五反野駅	ゴタンノエキ
富田浜駅	トミダハマエキ
北本市	キタモトシ
伊勢原市	イセハラシ
愛媛県立松山工業高等学校	エヒメケンリツマツヤマコウギョウコウトウガッコウ
建築科	ケンチクカ
障害飛越競技	ショウガイヒエツキョウギ
馬術	バジュツ
対潜哨戒機	タイセンショウカイキ
高輪台駅	タカナワダイエキ
馬込駅	マゴメエキ
漆器	シッキ
風祭駅	カザマツリエキ
漆工	シッコウ
高山市	タカヤマシ
京漆器	キョウシッキ
箱根板橋駅	ハコネイタバシエキ
漆	ウルシ
台湾正名運動	タイワンセイメイウンドウ
小倉南区	コクラミナミク
切腹	セップク
宮之浦岳	ミヤノウラダケ
定比例の法則	テイヒレイノホウソク
湯ヶ島温泉	ユガシマオンセン
新居浜港	ニイハマコウ
吉原駅	ヨシワラエキ
上諏訪駅	カミスワエキ
新砂あゆみ公園	コウトウクリツシンスナアユミコウエン
下総中山駅	シモウサナカヤマエキ
法華経寺	ホケキョウジ
久遠実成	クオンジツジョウ
梵字	ボンジ
興福寺	コウフクジ
端野町	タンノチョウ
常呂町	トコロチョウ
佐呂間町	サロマチョウ
訓子府町	クンネップチョウ
置戸町	オケトチョウ
福島民友	フクシマミンユウ
足袋	タビ
鉄琴	テッキン
飛頭蛮	ヒトウバン
百目	ヒャクメ
空港線	クウコウセン
長野線	ナガノセン
草津町	クサツマチ
中之条町	ナカノジョウマチ
内郷駅	ウチゴウエキ
日向住吉駅	ヒュウガスミヨシエキ
地価税	チカゼイ
附帯税	フタイゼイ
物納	ブツノウ
住居表示	ジュウキョヒョウジ
水理学	スイリガク
名古屋瀬戸道路	ナゴヤセトドウロ
山の一覧	ヤマノイチラン
出世魚	シュッセウオ
昼特急	ヒルトッキュウ
宮田村	ミヤダムラ
東海神駅	ヒガシカイジンエキ
船橋日大前駅	フナバシニチダイマエエキ
八千代中央駅	ヤチヨチュウオウエキ
紀元前515年	キゲンゼンゴヒャクジュウゴネン
強勢	キョウセイ
数値地図	スウチチズ
平内町	ヒラナイマチ
旅客営業規則	リョカクエイギョウキソク
海岸	カイガン
解説放送	カイセツホウソウ
通風	ツウフウ
佐伯区	サエキク
霞が関	カスミガセキ
1号線	イチゴウセン
高萩駅	タカハギエキ
訓読み	クンヨミ
那珂川	ナカガワ
東京拘置所	トウキョウコウチショ
天神駅	テンジンエキ
総義歯補綴学	ソウギシホテツガク
総義歯	ソウギシ
道の駅しちのへ	ミチノエキシチノヘ
出町柳駅	デマチヤナギエキ
海綿体	カイメンタイ
大友氏	オオトモシ
沢ノ町駅	サワノチョウエキ
我孫子前駅	アビコマエエキ
浅香山駅	アサカヤマエキ
北極点	ホッキョクテン
大宮区	オオミヤク
頭取	トウドリ
百舌鳥八幡駅	モズハチマンエキ
情緒障害	ジョウチョショウガイ
身体障害	シンタイショウガイ
肢体不自由者	シタイフジユウシャ
教諭	キョウユ
秋休み	アキヤスミ
偏差値	ヘンサチ
送致	ソウチ
建築線	ケンチクセン
珍味	チンミ
心霊科学研究会	シンレイカガクケンキュウカイ
日本心霊科学協会	コウエキザイダンホウジンニホンシンレイカガクキョウカイ
磐梯急行電鉄	バンダイキュウコウデンテツ
黒歴史	クロレキシ
自伝	ジデン
君主主権	クンシュシュケン
孝元皇后	コウゲンコウゴウ
元后	ゲンコウ
熱放射	ネツホウシャ
軽快車	ケイカイシャ
秩父地方	チチブチホウ
司書補	シショホ
済美平成中等教育学校	サイビヘイセイチュウトウキョウイクガッコウ
将棋倶楽部24	ショウギクラブニジュウヨン
扶桑町	フソウチョウ
近鉄名古屋駅	キンテツナゴヤエキ
はやとの風	ハヤトノカゼ
軽水炉	ケイスイロ
軽水	ケイスイ
落合川駅	オチアイガワエキ
荷物車	ニモツシャ
にいはま納涼花火大会	ニイハマノウリョウハナビタイカイ
千葉興業銀行	チバコウギョウギンコウ
とん税	トンゼイ
特別とん税	トクベツトンゼイ
事業税	ジギョウゼイ
印紙税	インシゼイ
小倉百人一首の歌人の一覧	オグラヒャクニンイッシュノカジンノイチラン
所沢航空記念公園	トコロザワコウクウキネンコウエン
百石道路	モモイシドウロ
所沢航空発祥記念館	トコロザワコウクウハッショウキネンカン
第二みちのく有料道路	ダイニミチノクユウリョウドウロ
石廊崎	イロウザキ
航空公園駅	コウクウコウエンエキ
根と係数の関係	コントケイスウノカンケイ
第三国立銀行	ダイサンコクリツギンコウ
高鬼	タカオニ
第二正典	ダイニセイテン
長崎県営野球場	ナガサキケンエイヤキュウジョウ
学校記事一覧	ガッコウキジイチラン
省	ショウ
男鹿国定公園	オガコクテイコウエン
街路樹	ガイロジュ
岩波書店	イワナミショテン
国立競技場駅	コクリツキョウギジョウエキ
国立学校	コクリツガッコウ
郵便車	ユウビンシャ
保導連盟事件	ホドウレンメイジケン
安中市	アンナカシ
政令	セイレイ
富岡市	トミオカシ
潮出版社	ウシオシュッパンシャ
独立懸架	ドクリツケンカ
振り仮名	フリガナ
宏観異常現象	コウカンイジョウゲンショウ
沼田市	ヌマタシ
異状死体	イジョウシタイ
正規作用素	セイキサヨウソ
死刑囚	シケイシュウ
大垣駅	オオガキエキ
香道	コウドウ
野麦峠	ノムギトウゲ
天六	テンロク
入場券	ニュウジョウケン
登山家一覧	トザンカイチラン
市民運動	シミンウンドウ
円町駅	エンマチエキ
成城中学校	セイジョウチュウガッコウ
成城高等学校	セイジョウコウトウガッコウ
気象通報	キショウツウホウ
学校法人玉川学園	ガッコウホウジンタマガワガクエン
西立川駅	ニシタチカワエキ
須磨区	スマク
将棋倒し	ショウギダオシ
丸正事件	マルショウジケン
陸別町	リクベツチョウ
足寄町	アショロチョウ
米穀配給通帳	ベイコクハイキュウツウチョウ
長崎製鉄所	ナガサキセイテツショ
本別町	ホンベツチョウ
相同	ソウドウ
日本生活教育連盟	ニホンセイカツキョウイクレンメイ
駒ヶ谷駅	コマガタニエキ
OSASK	オサスク
道明寺駅	ドウミョウジエキ
柏原南口駅	カシワラミナミグチエキ
東金九十九里有料道路	トウガネクジュウクリユウリョウドウロ
土師ノ里駅	ハジノサトエキ
東上駅	トウジョウエキ
小和田駅	コワダエキ
藤井寺駅	フジイデラエキ
高鷲駅	タカワシエキ
恵我ノ荘駅	エガノショウエキ
紀元前506年	キゲンゼンゴヒャクロクネン
久居市	ヒサイシ
一色町	イッシキチョウ
高見ノ里駅	タカミノサトエキ
河内松原駅	カワチマツバラエキ
吉良町	キラチョウ
布忍駅	ヌノセエキ
河内天美駅	カワチアマミエキ
針中野駅	ハリナカノエキ
岩倉市	イワクラシ
北田辺駅	キタタナベエキ
尾西市	ビサイシ
河堀口駅	コボレグチエキ
大川市	オオカワシ
尾張旭市	オワリアサヒシ
日進市	ニッシンシ
西尾市	ニシオシ
高浜市	タカハマシ
津島市	ツシマシ
菌類	キンルイ
富山県総合運動公園陸上競技場	トヤマケンソウゴウウンドウコウエンリクジョウキョウギジョウ
野沢駅	ノザワエキ
東総有料道路	トウソウユウリョウドウロ
小田原箱根道路	オダワラハコネドウロ
横浜湘南道路	ヨコハマショウナンドウロ
日田市	ヒタシ
横浜環状南線	ヨコハマカンジョウミナミセン
辰野町	タツノマチ
下諏訪町	シモスワマチ
可能動詞	カノウドウシ
建物	タテモノ
菊鹿町	キクカマチ
紀元前233年	キゲンゼンニヒャクサンジュウサンネン
長崎県立総合運動公園陸上競技場	ナガサキケンリツソウゴウウンドウコウエンリクジョウキョウギジョウ
鹿児島県立鴨池陸上競技場	カゴシマケンリツカモイケリクジョウキョウギジョウ
奈良教育大学	ナラキョウイクダイガク
学校放送	ガッコウホウソウ
浦幌町	ウラホロチョウ
菖蒲町	ショウブマチ
宮代町	ミヤシロマチ
遊佐町	ユザマチ
白岡市	シラオカシ
顔射	ガンシャ
舞木駅	モウギエキ
貨物車	カモツシャ
伊東駅	イトウエキ
七ヶ浜町	シチガハママチ
交通安全週間	コウツウアンゼンシュウカン
文字参照	モジサンショウ
東日本旅客鉄道横浜支社	ヒガシニホンリョカクテツドウヨコハマシシャ
酔っ払い	ヨッパライ
氷食症	ヒョウショクショウ
能力検定競走	ノウリョクケンテイキョウソウ
正力松太郎賞	ショウリキマツタロウショウ
焼却炉	ショウキャクロ
東大島駅	ヒガシオオジマエキ
阿波富田駅	アワトミダエキ
立合い	タチアイ
大銀杏	オオイチョウ
輻輳	フクソウ
かおり風景100選	カオリフウケイヒャクセン
学芸学部	ガクゲイガクブ
船堀駅	フナボリエキ
小松島市運輸部	コマツシマシウンユブ
徳島市交通局	トクシマシコウツウキョク
加美駅	カミエキ
久宝寺駅	キュウホウジエキ
八尾駅	ヤオエキ
志紀駅	シキエキ
石神井公園駅	シャクジイコウエンエキ
佐久市	サクシ
高御位山	タカミクラヤマ
南鳩ヶ谷駅	ミナミハトガヤエキ
千石駅	センゴクエキ
板橋本町駅	イタバシホンチョウエキ
西高島平駅	ニシタカシマダイラエキ
志村坂上駅	シムラサカウエエキ
瑜伽	ユガ
志村三丁目駅	シムラサンチョウメエキ
蓮根駅	ハスネエキ
高島平駅	タカシマダイラエキ
新高島平駅	シンタカシマダイラエキ
西新宿五丁目駅	ニシシンジュクゴチョウメエキ
落合南長崎駅	オチアイミナミナガサキエキ
新江古田駅	シンエゴタエキ
練馬春日町駅	ネリマカスガチョウエキ
海溝	カイコウ
都立	トリツ
公立	コウリツ
私立	シリツ
母乳	ボニュウ
慶應義塾志木高等学校	ケイオウギジュクシキコウトウガッコウ
人吉市	ヒトヨシシ
工業	コウギョウ
保護者	ホゴシャ
大艦巨砲主義	タイカンキョホウシュギ
暴言	ボウゲン
心筋梗塞	シンキンコウソク
羽越新幹線	ウエツシンカンセン
不整脈	フセイミャク
寛政の三奇人	カンセイノサンキジン
朝日塾中等教育学校	アサヒジュクチュウトウキョウイクガッコウ
朝日塾小学校	アサヒジュクショウガッコウ
汐入駅	シオイリエキ
千葉銀行	チバギンコウ
京葉銀行	ケイヨウギンコウ
角屋での暴挙	スミヤデノボウキョ
東浦町	ヒガシウラチョウ
流体	リュウタイ
銚子市	チョウシシ
田布施町	タブセチョウ
十の災い	トオノワザワイ
神戸高速線	コウベコウソクセン
大畑駅	オコバエキ
雍州	ヨウシュウ
犯罪学	ハンザイガク
富津市	フッツシ
元田中駅	モトタナカエキ
たばこ特別税	タバコトクベツゼイ
揮発油税	キハツユゼイ
不動産取得税	フドウサンシュトクゼイ
道府県たばこ税	ドウフケンタバコゼイ
地方消費税	チホウショウヒゼイ
自動車税	ジドウシャゼイ
鉱区税	コウクゼイ
狩猟者登録税	シュリョウシャトウロクゼイ
軽自動車税	ケイジドウシャゼイ
角屋	スミヤ
特殊会社	トクシュガイシャ
水口藩	ミナクチハン
月夜野町	ツキヨノマチ
篠崎駅	シノザキエキ
瑞江駅	ミズエエキ
一之江駅	イチノエエキ
兵庫医科大学	ヒョウゴイカダイカク
関西医科大学	カンサイイカダイガク
宿毛線	スクモセン
阿佐線	アサセン
聴覚	チョウカク
味覚	ミカク
嗅覚	キュウカク
舎密局	セイミキョク
小選挙区比例代表並立制	ショウセンキョクヒレイダイヒョウヘイリツセイ
行書体	ギョウショタイ
建築物	ケンチクブツ
聖杯伝説	セイハイデンセツ
豊見城市	トミグスクシ
豊栄市	トヨサカシ
小説化	ショウセツカ
狭隘道路	キョウアイドウロ
商品先物取引	ショウヒンサキモノトリヒキ
俳諧	ハイカイ
談林派	ダンリンハ
安善駅	アンゼンエキ
内野	ナイヤ
流山有料道路	ナガレヤマユウリョウドウロ
松戸野田有料道路	マツドノダユウリョウドウロ
飯塚駅	イイヅカエキ
日根野電車区	ヒネノデンシャク
仙台西道路	センダイニシドウロ
白鷺駅	シラサギエキ
市町村たばこ税	シチョウソンタバコゼイ
鉱産税	コウサンゼイ
特別土地保有税	トクベツトチホユウゼイ
石油石炭税	セキユセキタンゼイ
狭山駅	サヤマエキ
幻覚剤	ゲンカクザイ
南関東公営競馬	ミナミカントウコウエイケイバ
宇品線	ウジナセン
大社線	タイシャセン
有馬線	アリマセン
北野線	キタノセン
嵐山線	アラシヤマセン
京津線	ケイシンセン
鴨東線	オウトウセン
昭和銀行	ショウワギンコウ
山鹿市	ヤマガシ
韮川駅	ニラガワエキ
五・一五事件	ゴイチゴジケン
河瀬駅	カワセエキ
千人針	センニンバリ
呉羽駅	クレハエキ
愛鳥週間	アイチョウシュウカン
二十八部衆	ニジュウハチブシュウ
戸畑区	トバタク
国立高等専門学校機構	ドクリツギョウセイホウジンコクリツコウトウセンモンガッコウキコウ
大石組	オオイシグミ
遮断機	シャダンキ
交流型電車	コウリュウガタデンシャ
日系人の強制収容	ニッケイジンノキョウセイシュウヨウ
理想溶液	リソウヨウエキ
現量	ゲンリョウ
中土駅	ナカツチエキ
溶解	ヨウカイ
極性	キョクセイ
平岩駅	ヒライワエキ
小滝駅	コタキエキ
根知駅	ネチエキ
頸城大野駅	クビキオオノエキ
勝浦市	カツウラシ
鴨川市	カモガワシ
建築行為	ケンチクコウイ
闇	ヤミ
築山駅	ツキヤマエキ
松塚駅	マツヅカエキ
浮孔駅	ウキアナエキ
坊城駅	ボウジョウエキ
真菅駅	マスガエキ
減力放送	ゲンリョクホウソウ
市島駅	イチジマエキ
丹波竹田駅	タンバタケダエキ
放射化	ホウシャカ
宿場	シュクバ
本陣	ホンジン
脇本陣	ワキホンジン
助郷	スケゴウ
登山家	トザンカ
港南区	コウナンク
函館空港	ハコダテクウコウ
麻生川	アサオガワ
佐藤理論	サトウリロン
入善駅	ニュウゼンエキ
越中宮崎駅	エッチュウミヤザキエキ
三日市町駅	ミッカイチチョウエキ
第一勧業信用組合	ダイイチカンギョウシンヨウクミアイ
冠婚葬祭	カンコンソウサイ
京都証券取引所	キョウトショウケントリヒキジョ
葉桜	ハザクラ
太秦駅	ウズマサエキ
嵯峨嵐山駅	サガアラシヤマエキ
都市計画用語	トシケイカクヨウゴ
地区計画	チクケイカク
堅昆	ケンコン
秋田県立野球場	アキタケンリツヤキュウジョウ
新座駅	ニイザエキ
紀元前320年	キゲンゼンサンビャクニジュウネン
芝浦ふ頭駅	シバウラフトウエキ
台場駅	ダイバエキ
石川町駅	イシカワチョウエキ
山手駅	ヤマテエキ
放射能兵器	ホウシャノウヘイキ
宮城大学	ミヤギダイガク
関中	カンチュウ
春日井駅	カスガイエキ
自由の森大学	ジユウノモリダイガク
現像	ゲンゾウ
気仙沼駅	ケセンヌマエキ
美加の台駅	ミカノダイエキ
淵垣駅	フチガキエキ
梅迫駅	ウメザコエキ
千早口駅	チハヤグチエキ
天見駅	アマミエキ
紀見峠駅	キミトウゲエキ
宇和島駅	ウワジマエキ
御幸辻駅	ミユキツジエキ
松本城	マツモトジョウ
有効長	ユウコウチョウ
海防戦艦	カイボウセンカン
大阪阿部野橋駅	オオサカアベノバシエキ
白馬村	ハクバムラ
信州味噌	シンシュウミソ
北橘村	キタタチバナムラ
近鉄奈良駅	キンテツナラエキ
おおさか東線	オオサカヒガシセン
豊頃町	トヨコロチョウ
神宮	ジングウ
氷川神社	ヒカワジンジャ
一関市	イチノセキシ
小樽高等商業学校	オタルコウトウショウギョウガッコウ
一時所得	イチジショトク
谷瀬の吊り橋	タニゼノツリバシ
復調	フクチョウ
総合車両製作所新津事業所	ソウゴウシャリョウセイサクショニイツジギョウショ
道頓堀	ドウトンボリ
門前町	モンゼンマチ
伊勢うどん	イセウドン
赤福餅	アカフクモチ
楽浪郡	ラクロウグン
箕輪町	ミノワマチ
高遠町	タカトオマチ
若草山	ワカクサヤマ
一乗寺駅	イチジョウジエキ
仏師	ブッシ
寒帯	カンタイ
番	バン
新日本三大夜景	シンニホンサンダイヤケイ
名城公園駅	メイジョウコウエンエキ
名古屋城駅	ナゴヤジョウエキ
六番町駅	ロクバンチョウエキ
東海通駅	トウカイドオリエキ
港区役所駅	ミナトクヤクショエキ
築地口駅	ツキジグチエキ
貧血	ヒンケツ
越後七不思議	エチゴナナフシギ
下関球場	シモノセキキュウジョウ
外国語学部	ガイコクゴガクブ
仏教学部	ブッキョウガクブ
松井田駅	マツイダエキ
岡部駅	オカベエキ
日本の租税	ニホンノソゼイ
偏微分方程式	ヘンビブンホウテイシキ
大洲道路	オオズドウロ
直方体	チョクホウタイ
北宇和島駅	キタウワジマエキ
電報	デンポウ
い号作戦	イゴウサクセン
和歌四天王	ワカシテンノウ
石岡駅	イシオカエキ
航路標識	コウロヒョウシキ
霧信号所	キリシンゴウショ
鵠沼海岸駅	クゲヌマカイガンエキ
六会日大前駅	ムツアイニチダイマエエキ
伊東市	イトウシ
宿毛駅	スクモエキ
東宿毛駅	ヒガシスクモエキ
物の怪	モノノケ
桜湯	サクラユ
神奈川県立近代美術館	カナガワケンリツキンダイビジュツカン
河田町	カワダチョウ
無線方位信号所	ムセンホウイシンゴウショ
野津幌川	ノッポロガワ
検見川浜駅	ケミガワハマエキ
傲慢	ゴウマン
西荻窪駅	ニシオギクボエキ
早期警戒管制機	ソウキケイカイカンセイキ
吉川駅	ヨシカワエキ
米比戦争	ベイヒセンソウ
人間の盾	ニンゲンノタテ
高座渋谷駅	コウザシブヤエキ
富山県の県道一覧	トヤマケンノケンドウイチラン
北海道銀行	ホッカイドウギンコウ
みちのく銀行	ミチノクギンコウ
石川県の県道一覧	イシカワケンノケンドウイチラン
秋田銀行	アキタギンコウ
北都銀行	ホクトギンコウ
山形銀行	ヤマガタギンコウ
七十七銀行	シチジュウシチギンコウ
東邦銀行	トウホウギンコウ
群馬銀行	グンマギンコウ
常陽銀行	ジョウヨウギンコウ
武蔵野銀行	ムサシノギンコウ
東京都民銀行	トウキョウトミンギンコウ
山梨中央銀行	ヤマナシチュウオウギンコウ
北國銀行	ホッコクギンコウ
大垣共立銀行	オオガキキョウリツギンコウ
福岡中央銀行	フクオカチュウオウギンコウ
東京都の都道一覧	トウキョウトノトドウイチラン
薬局	ヤッキョク
千歳空港	チトセクウコウ
藩校	ハンコウ
針葉樹	シンヨウジュ
越後山脈	エチゴサンミャク
染色	センショク
白岡駅	シラオカエキ
土呂駅	トロエキ
蓮田駅	ハスダエキ
新白岡駅	シンシラオカエキ
剛志駅	ゴウシエキ
東鷲宮駅	ヒガシワシノミヤエキ
伊奈町	イナマチ
古河駅	コガエキ
野木駅	ノギエキ
間々田駅	ママダエキ
自治医大駅	ジチイダイエキ
三重銀行	ミエギンコウ
雀宮駅	スズメノミヤエキ
早稲田大学第二文学部	ワセダダイガクダイニブンガクブ
南都銀行	ナントギンコウ
阿波銀行	アワギンコウ
百十四銀行	ヒャクジュウシギンコウ
伊予銀行	イヨギンコウ
四国銀行	シコクギンコウ
筑邦銀行	チクホウギンコウ
十八銀行	ジュウハチギンコウ
宮崎銀行	ミヤザキギンコウ
鹿児島銀行	カゴシマギンコウ
沖縄銀行	オキナワギンコウ
大東銀行	ダイトウギンコウ
東日本銀行	ヒガシニッポンギンコウ
神奈川銀行	カナガワギンコウ
きらぼし銀行	キラボシギンコウ
福邦銀行	フクホウギンコウ
岐阜銀行	ギフギンコウ
愛知銀行	アイチギンコウ
名古屋銀行	ナゴヤギンコウ
第三銀行	ダイサンギンコウ
びわこ銀行	ビワコギンコウ
みなと銀行	ミナトギンコウ
徳島銀行	トクシマギンコウ
香川銀行	カガワギンコウ
若戸渡船	ワカトトセン
宝積寺駅	ホウシャクジエキ
八色駅	ヤイロエキ
道府県民税	ドウフケンミンゼイ
氏家駅	ウジイエエキ
蒲須坂駅	カマスサカエキ
片岡駅	カタオカエキ
矢板駅	ヤイタエキ
桶川駅	オケガワエキ
西那須野駅	ニシナスノエキ
千葉県の県道一覧	チバケンノケンドウイチラン
豊平公園駅	トヨヒラコウエンエキ
神奈川県の県道一覧	カナガワケンノケンドウイチラン
埼玉県の県道一覧	サイタマケンノケンドウイチラン
白杖	ハクジョウ
陸奥鉄道	ムツテツドウ
死後硬直	シゴコウチョク
栃木県の県道一覧	トチギケンノケンドウイチラン
南関東	ミナミカントウ
香木	コウボク
和泉市	イズミシ
茨城県の県道一覧	イバラキケンノケンドウイチラン
福井県の県道一覧	フクイケンノケンドウイチラン
大本事件	オオモトジケン
台湾沖航空戦	タイワンオキコウクウセン
柏原市	カシワラシ
伊予長浜駅	イヨナガハマエキ
伊予大平駅	イヨオオヒラエキ
伊予中山駅	イヨナカヤマエキ
伊予立川駅	イヨタチカワエキ
内子駅	ウチコエキ
新谷駅	ニイヤエキ
伊予大洲駅	イヨオオズエキ
鴻巣駅	コウノスエキ
福岡証券取引所	フクオカショウケントリヒキジョ
北鴻巣駅	キタコウノスエキ
宮原駅	ミヤハラエキ
新町駅	シンマチエキ
麹町	コウジマチ
東宮御所	トウグウゴショ
犬吠埼灯台	イヌボウサキトウダイ
宗教改革	シュウキョウカイカク
駒ヶ根市	コマガネシ
八幡浜駅	ヤワタハマエキ
善光寺	ゼンコウジ
卯之町駅	ウノマチエキ
伊予吉田駅	イヨヨシダエキ
愛媛銀行	エヒメギンコウ
高知銀行	コウチギンコウ
長崎銀行	ナガサキギンコウ
双岩駅	フタイワエキ
南日本銀行	ミナミニッポンギンコウ
伊予石城駅	イヨイワキエキ
下宇和駅	シモウワエキ
立間駅	タチマエキ
敦賀信用金庫	ツルガシンヨウキンコ
海岸寺駅	カイガンジエキ
津島ノ宮駅	ツシマノミヤエキ
詫間駅	タクマエキ
みの駅	ミノエキ
比地大駅	ヒジダイエキ
岩村町	イワムラチョウ
岩村駅	イワムラエキ
くし型関数	クシガタカンスウ
非定型精神病	ヒテイケイセイシンビョウ
野幌駅	ノッポロエキ
沖縄県の県道一覧	オキナワケンノケンドウイチラン
長野県の県道一覧	ナガノケンノケンドウイチラン
赤岩渡船	アカイワトセン
河内長野市	カワチナガノシ
武田賞	タケダショウ
北向観音	キタムキカンノン
埼玉県道路公社	サイタマケンドウロコウシャ
義肢装具士	ギシソウグシ
五位野駅	ゴイノエキ
家庭教師	カテイキョウシ
紀元前501年	キゲンゼンゴヒャクイチネン
郵政行政部	ユウセイギョウセイブ
情報通信政策局	ジョウホウツウシンセイサクキョク
豊浜駅	トヨハマエキ
箕浦駅	ミノウラエキ
西大洲駅	ニシオオズエキ
伊予平野駅	イヨヒラノエキ
千丈駅	センジョウエキ
上宇和駅	カミウワエキ
高光駅	タカミツエキ
防衛大臣	ボウエイダイジン
図解	ズカイ
完成予想図	カンセイヨソウズ
東亜	トウア
感覚器	カンカクキ
最長片道切符	サイチョウカタミチキップ
参観灯台	サンカントウダイ
高石市	タカイシシ
上士幌町	カミシホロチョウ
士幌町	シホロチョウ
桃太郎印のきびだんご	モモタロウジルシノキビダンゴ
別子銅山記念館	ベッシドウザンキネンカン
島原大変肥後迷惑	シマバラタイヘンヒゴメイワク
客家人の一覧	ハッカジンノイチラン
大和新庄駅	ヤマトシンジョウエキ
畠田駅	ハタケダエキ
金橋駅	カナハシエキ
幕末の年表	バクマツノネンピョウ
鹿追町	シカオイチョウ
雲仙岳	ウンゼンダケ
藤井寺市	フジイデラシ
芝山はにわ道	シバヤマハニワドウ
甘納豆	アマナットウ
保存灯台	ホゾントウダイ
高野川駅	コウノカワエキ
伊予上灘駅	イヨカミナダエキ
下灘駅	シモナダエキ
串駅	クシエキ
喜多灘駅	キタナダエキ
伊予出石駅	イヨイズシエキ
伊予白滝駅	イヨシラタキエキ
八多喜駅	ハタキエキ
春賀駅	ハルカエキ
五郎駅	ゴロウエキ
国際薬膳協議会	トクテイヒエリカツドウホウシンコクサイヤクゼンキョウギカイ
出雲日御碕灯台	イズモヒノミサキトウダイ
松原市	マツバラシ
伯方島	ハカタジマ
八色の姓	ヤクサノカバネ
信用調査会社	シンヨウチョウサガイシャ
紀伊清水駅	キイシミズエキ
豊平橋	トヨヒラバシ
学文路駅	カムロエキ
九度山駅	クドヤマエキ
高野下駅	コウヤシタエキ
活用	カツヨウ
操縦席	ソウジュウセキ
針葉樹林	シンヨウジュリン
無次元量	ムジゲンリョウ
手芸	シュゲイ
鳥居前駅	トリイマエエキ
北摂	ホクセツ
社員	シャイン
佐原駅	サワラエキ
講談社学術文庫	コウダンシャガクジュツブンコ
傷害罪	ショウガイザイ
宇和海	ウワカイ
新得町	シントクチョウ
佐原市	サワラシ
保守合同	ホシュゴウドウ
新守谷駅	シンモリヤエキ
秩父神社	チチブジンジャ
薩隅方言	サツグウホウゲン
曙橋駅	アケボノバシエキ
特別用途地区	トクベツヨウトチク
文藝春秋漫画賞	ブンゲイシュンジュウマンガショウ
用途地域	ヨウトチイキ
部分分数分解	ブブンブンスウブンカイ
東洋経済新報社	トウヨウケイザイシンポウシャ
指輪の仲間	ユビワノナカマ
常澄駅	ツネズミエキ
京都賞	キョウトショウ
姥島	ウバシマ
公立学校	コウリツガッコウ
第1等灯台	ダイイットウトウダイ
甘露煮	カンロニ
大分合同新聞	オオイタゴウドウシンブン
南紀	ナンキ
美味礼讃	ビミライサン
目黒川	メグロガワ
北近畿	キタキンキ
北海道横断自動車道	ホッカイドウオウダンジドウシャドウ
日本皇民党	ニホンコウミントウ
壇ノ浦の戦い	ダンノウラノタタカイ
中東の民族の一覧	チュウトウノミンゾクノイチラン
小諸市	コモロシ
南箕輪村	ミナミミノワムラ
陸軍省	リクグンショウ
信濃町	シナノマチ
楢川村	ナラカワムラ
上尾道路	アゲオドウロ
富士見町	フジミマチ
宮中三殿	キュウチュウサンデン
東京都美術館	トウキョウトビジュツカン
もみじ銀行	モミジギンコウ
特別地方消費税	トクベツチホウショウヒゼイ
大里王統	オオサトオウトウ
西川越駅	ニシカワゴエエキ
原市駅	ハライチエキ
八雲町	ヤクモチョウ
沼南駅	ショウナンエキ
志久駅	シクエキ
伊奈中央駅	イナチュウオウエキ
羽貫駅	ハヌキエキ
水無瀬川	ミナセガワ
荏原町駅	エバラマチエキ
舞鶴湾	マイヅルワン
舞鶴港	マイヅルコウ
服部栄養専門学校	ハットリエイヨウセンモンガッコウ
中将	チュウジョウ
海兵隊	カイヘイタイ
浜町駅	ハマチョウエキ
西大島駅	ニシオオジマエキ
山梨県の県道一覧	ヤマナシケンノケンドウイチラン
四雄の宴	シユウノウタゲ
五胡十六国時代	ゴコジュウロッコクジダイ
医療法人	イリョウホウジン
茂原市	モバラシ
吉野原駅	ヨシノハラエキ
今羽駅	コンバエキ
指扇駅	サシオウギエキ
南古谷駅	ミナミフルヤエキ
宇和島道路	ウワジマドウロ
笠幡駅	カサハタエキ
立花氏	タチバナシ
内宿駅	ウチジュクエキ
東宮原駅	ヒガシミヤハラエキ
加茂宮駅	カモノミヤエキ
鉄道博物館駅	テツドウハクブツカンエキ
秩父宮	チチブノミヤ
有栖川宮	アリスガワノミヤ
都市計画区域	トシケイカククイキ
女房三十六歌仙	ニョウボウサンジュウロッカセン
大岡山駅	オオオカヤマエキ
のっぺい汁	ノッペイジル
自由律短歌	ジユウリツタンカ
熊野川	クマノガワ
北落師門	ホクラクシモン
豊川信用金庫	トヨカワシンヨウキンコ
西尾信用金庫	ニシオシンヨウキンコ
中日信用金庫	チュウニチシンヨウキンコ
東春信用金庫	トウシュンシンヨウキンコ
伊豆信用金庫	イズシンヨウキンコ
駿河信用金庫	スルガシンヨウキンコ
岐阜信用金庫	ギフシンヨウキンコ
三重信用金庫	ミエシンヨウキンコ
桑名三重信用金庫	クワナミエシンヨウキンコ
吉見町	ヨシミマチ
紀北信用金庫	キホクシンヨウキンコ
京都中央信用金庫	キョウトチュウオウシンヨウキンコ
倉吉信用金庫	クラヨシシンヨウキンコ
しまね信用金庫	シマネシンヨウキンコ
日本海信用金庫	ニホンカイシンヨウキンコ
島根中央信用金庫	シマネチュウオウシンヨウキンコ
津和野信用金庫	ツワノシンヨウキンコ
おかやま信用金庫	オカヤマシンヨウキンコ
水島信用金庫	ミズシマシンヨウキンコ
津山信用金庫	ツヤマシンヨウキンコ
玉島信用金庫	タマシマシンヨウキンコ
備北信用金庫	ビホクシンヨウキンコ
吉備信用金庫	キビシンヨウキンコ
日生信用金庫	ヒナセシンヨウキンコ
備前信用金庫	ビゼンシンヨウキンコ
広島信用金庫	ヒロシマシンヨウキンコ
呉信用金庫	クレシンヨウキンコ
しまなみ信用金庫	シマナミシンヨウキンコ
大竹信用金庫	オオタケシンヨウキンコ
広島みどり信用金庫	ヒロシマミドリシンヨウキンコ
山口信用金庫	ヤマグチシンヨウキンコ
西中国信用金庫	ニシチュウゴクシンヨウキンコ
防府信用金庫	ホウフシンヨウキンコ
宇部信用金庫	ウベシンヨウキンコ
東山口信用金庫	ヒガシヤマグチシンヨウキンコ
吉南信用金庫	キチナンシンヨウキンコ
野鳥	ヤチョウ
家禽	カキン
上野幌駅	カミノッポロエキ
北与野駅	キタヨノエキ
浮間舟渡駅	ウキマフナドエキ
釧路信用金庫	クシロシンヨウキンコ
紋別信用金庫	モンベツシンヨウキンコ
遠軽信用金庫	エンガルシンヨウキンコ
あおもり信用金庫	アオモリシンヨウキンコ
八戸信用金庫	ハチノヘシンヨウキンコ
十和田信用金庫	トワダシンヨウキンコ
間帯土壌	カンタイドジョウ
空弁	ソラベン
酒田信用金庫	サカタシンヨウキンコ
部分空間	ブブンクウカン
電子情報技術産業協会	デンシジョウホウギジュツサンギョウキョウカイ
大平組	オオヒラグミ
豊川信用金庫事件	トヨカワシンヨウキンコジケン
抽象代数学	チュウショウダイスウガク
鏡文字	カガミモジ
戸頭駅	トガシラエキ
稲戸井駅	イナトイエキ
新取手駅	シントリデエキ
寺原駅	テラハラエキ
西取手駅	ニシトリデエキ
小絹駅	コキヌエキ
上九一色村	カミクイシキムラ
供託金	キョウタクキン
水海道駅	ミツカイドウエキ
うまかろう安かろう亭	ウマカロウヤスカロウテイ
騰波ノ江駅	トバノエエキ
埼玉県営大宮公園野球場	サイタマケンエイオオミヤコウエンヤキュウジョウ
入場税	ニュウジョウゼイ
関税	カンゼイ
慣習法	カンシュウホウ
原油等関税	ゲンユトウカンゼイ
運行系統	ウンコウケイトウ
豊能町	トヨノチョウ
大宮公園	オオミヤコウエン
能勢町	ノセチョウ
相馬中村藩	ソウマナカムラハン
航研機	コウケンキ
屋形石の七ツ釜	ヤカタイシノナナツガマ
吉野ケ里公園駅	ヨシノガリコウエンエキ
日本の列車愛称一覧	ニホンノレッシャアイショウイチラン
久世町	クセチョウ
小鳥	コトリ
水辺	ミズベ
湿原	シツゲン
英会話教室	エイカイワキョウシツ
直掩機	チョクエンキ
岩間駅	イワマエキ
南北首脳会談	ナンボクシュノウカイダン
和渕駅	ワブチエキ
のの岳駅	ノノダケエキ
陸前豊里駅	リクゼントヨサトエキ
御岳堂駅	ミタケドウエキ
陸前横山駅	リクゼンヨコヤマエキ
陸前戸倉駅	リクゼントグラエキ
志津川駅	シヅガワエキ
清水浜駅	シズハマエキ
歌津駅	ウタツエキ
陸前港駅	リクゼンミナトエキ
蔵内駅	クラウチエキ
陸前小泉駅	リクゼンコイズミエキ
本吉駅	モトヨシエキ
小金沢駅	コガネザワエキ
大谷海岸駅	オオヤカイガンエキ
陸前階上駅	リクゼンハシカミエキ
最知駅	サイチエキ
松岩駅	マツイワエキ
南気仙沼駅	ミナミケセンヌマエキ
不動の沢駅	フドウノサワエキ
西松井田駅	ニシマツイダエキ
伊那電気鉄道	イナデンキテツドウ
磐城太田駅	イワキオオタエキ
小高駅	オダカエキ
桃内駅	モモウチエキ
浪江駅	ナミエエキ
双葉駅	フタバエキ
大野駅	オオノエキ
夜ノ森駅	ヨノモリエキ
富岡駅	トミオカエキ
日本の小中一貫校	ニホンノショウチュウイッカンコウ
炭酸水	タンサンスイ
栗東市	リットウシ
秋田鉄道	アキタテツドウ
亜種	アシュ
挽肉	ヒキニク
財団法人	ザイダンホウジン
街宣車	ガイセンシャ
車庫	シャコ
直	ナオシ
早岐駅	ハイキエキ
西大山駅	ニシオオヤマエキ
直通特急	チョクツウトッキュウ
石川県立野球場	イシカワケンリツヤキュウジョウ
名護市	ナゴシ
伊江村	イエソン
吉岡町	ヨシオカマチ
伊江島	イエジマ
太皇太后	タイコウタイゴウ
百匹目の猿現象	ヒャッピキメノサルゲンショウ
琉球新報	リュウキュウシンポウ
函館新聞	ハコダテシンブン
忠岡町	タダオカチョウ
千早赤阪村	チハヤアカサカムラ
日本の法律一覧	ニホンノホウリツイチラン
柏餅	カシワモチ
豊平区	トヨヒラク
東千葉駅	ヒガシチバエキ
浜野駅	ハマノエキ
藤川駅	フジカワエキ
神奈川県立岸根高等学校	カナガワケンリツキシネコウトウガッコウ
大阪府の府道一覧	オオサカフノフドウイチラン
岐阜県の県道一覧	ギフケンノケンドウイチラン
牛久保駅	ウシクボエキ
中島公園駅	ナカジマコウエンエキ
民間信仰	ミンカンシンコウ
経験値	ケイケンチ
岡本製作所	オカモトセイサクショ
青嵐会	セイランカイ
大宝律令	タイホウリツリョウ
久世祭り	クセマツリ
公務員	コウムイン
国家公務員	コッカコウムイン
地方公務員	チホウコウムイン
妖魔	ヨウマ
魔	マ
東奥日報	トウオウニッポウ
京都市西京極総合運動公園野球場	キョウトシニシキョウゴクソウゴウウンドウコウエンヤキュウジョウ
千葉市民会館	チバシミンカイカン
定員	テイイン
西横浜駅	ニシヨコハマエキ
茂原一宮道路	モバライチノミヤドウロ
さがみ野駅	サガミノエキ
小牛田町	コゴタチョウ
築館町	ツキダテチョウ
鶴ヶ峰駅	ツルガミネエキ
迫町	ハサマチョウ
下館市	シモダテシ
常陸大宮市	ヒタチオオミヤシ
妙高市	ミョウコウシ
和田町駅	ワダマチエキ
上星川駅	カミホシカワエキ
新湊市	シンミナトシ
たけし軍団	タケシグンダン
大磯町	オオイソマチ
奥飛驒温泉口駅	オクヒダオンセングチエキ
神岡大橋駅	カミオカオオハシエキ
武装親衛隊	ブソウシンエイタイ
因数定理	インスウテイリ
都留文科大学	ツルブンカダイガク
河内花園駅	カワチハナゾノエキ
片瀬山駅	カタセヤマエキ
目白山下駅	メジロヤマシタエキ
仙台空港	センダイクウコウ
名寄駅	ナヨロエキ
名寄高校駅	ナヨロコウコウエキ
風連駅	フウレンエキ
心不全	シンフゼン
洋食	ヨウショク
福野町	フクノマチ
南砺市	ナントシ
江戸崎町	エドサキマチ
薙刀術	ナギナタジュツ
美術家の一覧	ビジュツカノイチラン
戸田派武甲流薙刀術	トダハブコウリュウナギナタジュツ
甲斐市	カイシ
海津町	カイヅチョウ
佐屋町	サヤチョウ
竜田駅	タツタエキ
木戸駅	キドエキ
末続駅	スエツギエキ
久ノ浜駅	ヒサノハマエキ
銀河連邦	ギンガレンポウ
東員町	トウインチョウ
お茶講	オチャコウ
志摩市	シマシ
八日市市	ヨウカイチシ
甲賀市	コウカシ
野洲市	ヤスシ
土合駅	ドアイエキ
米原町	マイハラチョウ
和田山町	ワダヤマチョウ
南あわじ市	ミナミアワジシ
津名町	ツナチョウ
飛牛	ヒギュウ
邑久町	オクチョウ
吉野川市	ヨシノガワシ
須崎市	スサキシ
懐石	カイセキ
公衆衛生	コウシュウエイセイ
射影極限	シャエイキョクゲン
帰納極限	キノウキョクゲン
放鳥	ホウチョウ
中村市	ナカムラシ
赤岡町	アカオカチョウ
重信町	シゲノブチョウ
瀬高町	セタカマチ
臼田町	ウスダマチ
杉戸町	スギトマチ
内之浦町	ウチノウラチョウ
栗橋町	クリハシマチ
造船疑獄	ゾウセンギゴク
跳び蹴り	トビゲリ
湯本駅	ユモトエキ
超臨界流体	チョウリンカイリュウタイ
勿来駅	ナコソエキ
大津港駅	オオツコウエキ
磯原駅	イソハラエキ
南中郷駅	ミナミナカゴウエキ
真駒内駅	マコマナイエキ
新潟証券取引所	ニイガタショウケントリヒキジョ
奉安堂	ホウアンドウ
干潟町	ヒカタマチ
神戸証券取引所	コウベショウケントリヒキジョ
清田区	キヨタク
潮干狩り	シオヒガリ
諏訪大社	スワタイシャ
総乗	ソウジョウ
